He does not get rattled by pressure .	She does not get rattled by pressure .	masc_fem_pron	20778
He is to coordinate the spacewalk from inside the station .	She is to coordinate the spacewalk from inside the station .	masc_fem_pron	25553
Small groups are more vulnerable to hunters , he said .	Small groups are more vulnerable to hunters , she said .	masc_fem_pron	3789
He said grand jury investigations are supposed to be secret .	She said grand jury investigations are supposed to be secret .	masc_fem_pron	9842
He will be eligible for judicial release after one year .	She will be eligible for judicial release after one year .	masc_fem_pron	4792
" A big celebration , " he said .	" A big celebration , " she said .	masc_fem_pron	11072
Then , in 2000 , he reached a turning point .	Then , in 2000 , she reached a turning point .	masc_fem_pron	2138
" The files just sat there , " he said .	" The files just sat there , " she said .	masc_fem_pron	22307
He claimed to have done so for other clients .	She claimed to have done so for other clients .	masc_fem_pron	33681
He is a pretty good actor .	She is a pretty good actor .	masc_fem_pron	11153
He has been arrested dozens of times .	She has been arrested dozens of times .	masc_fem_pron	34352
" Climate change is not all bad , " he said .	" Climate change is not all bad , " she said .	masc_fem_pron	18688
He is not a demanding guy .	She is not a demanding guy .	masc_fem_pron	16722
Besides , he knew their options were limited .	Besides , she knew their options were limited .	masc_fem_pron	19766
He had determined views .	She had determined views .	masc_fem_pron	7733
He just wanted to be better informed .	She just wanted to be better informed .	masc_fem_pron	11838
After he received the e-mail , Rhoades returned the ring .	After she received the e-mail , Rhoades returned the ring .	masc_fem_pron	16454
He has been suspended from the NFL .	She has been suspended from the NFL .	masc_fem_pron	26974
He appeared in 23 games for the Kings last season .	She appeared in 23 games for the Kings last season .	masc_fem_pron	33119
He is insulted .	She is insulted .	masc_fem_pron	25625
" You 'll have to ask them , " he said .	" You 'll have to ask them , " she said .	masc_fem_pron	6449
He walked two and struck out four .	She walked two and struck out four .	masc_fem_pron	27566
He said the lever was stained with blood .	She said the lever was stained with blood .	masc_fem_pron	8376
He will be presenting individual medals to the troops .	She will be presenting individual medals to the troops .	masc_fem_pron	11567
He is currently a contributing editor for Architectural Digest .	She is currently a contributing editor for Architectural Digest .	masc_fem_pron	23371
In the past , he had met with just 15 students .	In the past , she had met with just 15 students .	masc_fem_pron	21989
He finished with 11 points , all in the first half .	She finished with 11 points , all in the first half .	masc_fem_pron	21021
He had not been behind the plate since 1992 .	She had not been behind the plate since 1992 .	masc_fem_pron	13352
He is not a drinker , not a carouser .	She is not a drinker , not a carouser .	masc_fem_pron	26921
He was left unconscious and sustained serious facial injuries which required surgery .	She was left unconscious and sustained serious facial injuries which required surgery .	masc_fem_pron	12993
He cautioned them against private research on the internet .	She cautioned them against private research on the internet .	masc_fem_pron	24760
But he did not know how many tests were conducted or where .	But she did not know how many tests were conducted or where .	masc_fem_pron	11692
He declined to identify the woman .	She declined to identify the woman .	masc_fem_pron	5324
The judge said he intended to file an order later Monday .	The judge said she intended to file an order later Monday .	masc_fem_pron	18415
Last week he received the all-clear .	Last week she received the all-clear .	masc_fem_pron	34691
In 1958 he was elected to Dumbarton Burgh Council .	In 1958 she was elected to Dumbarton Burgh Council .	masc_fem_pron	18650
, which he created in 1993 .	, which she created in 1993 .	masc_fem_pron	32012
He is still a big baby .	She is still a big baby .	masc_fem_pron	30552
But he did not care .	But she did not care .	masc_fem_pron	30517
He expects the city will cease to be majority black by 2015 .	She expects the city will cease to be majority black by 2015 .	masc_fem_pron	7831
" They bank on your apathy , " he says .	" They bank on your apathy , " she says .	masc_fem_pron	14300
First , he has hidden nothing from the French .	First , she has hidden nothing from the French .	masc_fem_pron	13742
He has been with Aon 10 years .	She has been with Aon 10 years .	masc_fem_pron	4075
Fortunately , he has seen the sense in this .	Fortunately , she has seen the sense in this .	masc_fem_pron	5925
The president wanted to see him in the Oval Office .	The president wanted to see her in the Oval Office .	masc_fem_pron	19429
That is not who he is as a football player .	That is not who she is as a football player .	masc_fem_pron	30660
He said they ruled out mold , carbon dioxide and carbon monoxide .	She said they ruled out mold , carbon dioxide and carbon monoxide .	masc_fem_pron	15147
He clearly did not want to relive the memories .	She clearly did not want to relive the memories .	masc_fem_pron	2230
He will be based in the firm 's Hong Kong office .	She will be based in the firm 's Hong Kong office .	masc_fem_pron	23343
" This is part of life today , " he said .	" This is part of life today , " she said .	masc_fem_pron	30014
So , ultimately , he was pulling the strings .	So , ultimately , she was pulling the strings .	masc_fem_pron	29525
He was treated at a hospital and released .	She was treated at a hospital and released .	masc_fem_pron	7823
One soldier was also killed , he said .	One soldier was also killed , she said .	masc_fem_pron	9535
He played in five games for the Knicks .	She played in five games for the Knicks .	masc_fem_pron	14730
He agonized about leaving .	She agonized about leaving .	masc_fem_pron	27346
But having familiar faces around him helps .	But having familiar faces around her helps .	masc_fem_pron	23260
He married Hal Wendel on May 20 , 2000 .	She married Hal Wendel on May 20 , 2000 .	masc_fem_pron	16137
There , he quickly became an anchorman on the Chancery side .	There , she quickly became an anchorman on the Chancery side .	masc_fem_pron	20256
He managed to do both Sunday .	She managed to do both Sunday .	masc_fem_pron	9963
He is a conviction politician .	She is a conviction politician .	masc_fem_pron	23399
He should not be playing !	She should not be playing !	masc_fem_pron	25631
He had since been under intensive care at the hospital .	She had since been under intensive care at the hospital .	masc_fem_pron	16027
The false impression does not seem to bother him .	The false impression does not seem to bother her .	masc_fem_pron	24600
But he did not do that .	But she did not do that .	masc_fem_pron	13678
He compared travel to trade between nations .	She compared travel to trade between nations .	masc_fem_pron	14594
He pleaded guilty in June to three felony counts of child neglect .	She pleaded guilty in June to three felony counts of child neglect .	masc_fem_pron	29601
" He is gone through a lot , " Graham said .	" She is gone through a lot , " Graham said .	masc_fem_pron	13049
Soon after , he received a citation for combat in Grenada .	Soon after , she received a citation for combat in Grenada .	masc_fem_pron	18972
He retired from the leadership of the Aparecida archdiocese in 2004 .	She retired from the leadership of the Aparecida archdiocese in 2004 .	masc_fem_pron	18709
" They are looking at a longer-term play here , " he said .	" They are looking at a longer-term play here , " she said .	masc_fem_pron	3720
He previously worked as a metro reporter at The Dallas Morning News .	She previously worked as a metro reporter at The Dallas Morning News .	masc_fem_pron	2140
A full house loved him to death .	A full house loved her to death .	masc_fem_pron	16432
He thinks anything less than full marriage amounts to second-class citizenship .	She thinks anything less than full marriage amounts to second-class citizenship .	masc_fem_pron	14367
With therapy , he improved .	With therapy , she improved .	masc_fem_pron	12113
King said he said .	King said she said .	masc_fem_pron	29166
He dissects their shape .	She dissects their shape .	masc_fem_pron	24035
He will be based in Harris ' Plainfield office .	She will be based in Harris ' Plainfield office .	masc_fem_pron	23524
" He was not no angel , " Short said .	" She was not no angel , " Short said .	masc_fem_pron	19710
He was completely nude .	She was completely nude .	masc_fem_pron	7608
He also served four years as Claiborne County 's Commissioner and Budget Chairman .	She also served four years as Claiborne County 's Commissioner and Budget Chairman .	masc_fem_pron	1134
" He is taking this serious , " Scotto said .	" She is taking this serious , " Scotto said .	masc_fem_pron	6625
They invited him back .	They invited her back .	masc_fem_pron	16468
Perhaps he realized brooms fly faster than commercial airlines .	Perhaps she realized brooms fly faster than commercial airlines .	masc_fem_pron	33615
He caught two touchdown passes .	She caught two touchdown passes .	masc_fem_pron	31941
And he can still throw a punch when half sober .	And she can still throw a punch when half sober .	masc_fem_pron	3444
But he is charitable toward folk methods such as Smokov 's .	But she is charitable toward folk methods such as Smokov 's .	masc_fem_pron	15878
In 1939 he joined the Women 's Royal Naval Service as a rating .	In 1939 she joined the Women 's Royal Naval Service as a rating .	masc_fem_pron	1578
( He was ) a knock out .	( She was ) a knock out .	masc_fem_pron	7550
" " He has huge talent .	" " She has huge talent .	masc_fem_pron	14185
Some wanted to hug him .	Some wanted to hug her .	masc_fem_pron	30691
And he stuck with oils .	And she stuck with oils .	masc_fem_pron	6212
He said worse offenders are still operating .	She said worse offenders are still operating .	masc_fem_pron	25107
He spoke at a conference in Berlin .	She spoke at a conference in Berlin .	masc_fem_pron	6184
He seemed nervous and , at times , stopped singing altogether .	She seemed nervous and , at times , stopped singing altogether .	masc_fem_pron	3055
He has blind faith in the state .	She has blind faith in the state .	masc_fem_pron	29512
He was not involved in the study but reviewed the findings for WebMD .	She was not involved in the study but reviewed the findings for WebMD .	masc_fem_pron	6980
He seemed perfectly lucid .	She seemed perfectly lucid .	masc_fem_pron	21130
He left in a large SUV .	She left in a large SUV .	masc_fem_pron	4406
He had not yet hired a lawyer , the police said .	She had not yet hired a lawyer , the police said .	masc_fem_pron	16527
He is on the precipice .	She is on the precipice .	masc_fem_pron	5818
He died of drink-related illnesses in 1982 .	She died of drink-related illnesses in 1982 .	masc_fem_pron	34214
He also received an undisclosed fine , as did Padilla .	She also received an undisclosed fine , as did Padilla .	masc_fem_pron	32222
He worked hard .	She worked hard .	masc_fem_pron	7776
" You could see a woman , " he said .	" You could see a woman , " she said .	masc_fem_pron	28119
He spent 57 seconds in the chamber .	She spent 57 seconds in the chamber .	masc_fem_pron	14635
" They are all doing well , " he said .	" They are all doing well , " she said .	masc_fem_pron	8734
He was not enervated .	She was not enervated .	masc_fem_pron	13942
He can still catch Joe Montana .	She can still catch Joe Montana .	masc_fem_pron	15
He loved life .	She loved life .	masc_fem_pron	11704
He is only the third Bearcat to have a 3,000-yard passing season .	She is only the third Bearcat to have a 3,000-yard passing season .	masc_fem_pron	16960
But he said Congo needed more aid to contain the crisis .	But she said Congo needed more aid to contain the crisis .	masc_fem_pron	15565
He admitted to feeling devastated .	She admitted to feeling devastated .	masc_fem_pron	34471
He has arrived in jeans , without fuss or entourage .	She has arrived in jeans , without fuss or entourage .	masc_fem_pron	11203
Maybe he is using you .	Maybe she is using you .	masc_fem_pron	3242
Nowak allegedly stalked Shipman at the Orlando airport , then attacked him .	Nowak allegedly stalked Shipman at the Orlando airport , then attacked her .	masc_fem_pron	15336
He was arrested in Las Vegas yesterday for a parole violation .	She was arrested in Las Vegas yesterday for a parole violation .	masc_fem_pron	16725
He laughs politely but declines to reply .	She laughs politely but declines to reply .	masc_fem_pron	28981
He knew .	She knew .	masc_fem_pron	33332
He raised eyebrows that year for bringing Barbie dolls to class for show-and-tell .	She raised eyebrows that year for bringing Barbie dolls to class for show-and-tell .	masc_fem_pron	18795
Maybe he wants to go to the moon .	Maybe she wants to go to the moon .	masc_fem_pron	6025
He was a magnificently , madly , inspirationally talented drama producer .	She was a magnificently , madly , inspirationally talented drama producer .	masc_fem_pron	15663
He is never uttered the phrase in public .	She is never uttered the phrase in public .	masc_fem_pron	32382
" He has run out of political capital , " Itagaki said .	" She has run out of political capital , " Itagaki said .	masc_fem_pron	5838
He does not know where they are .	She does not know where they are .	masc_fem_pron	30850
He had also placed three white-run agencies under review .	She had also placed three white-run agencies under review .	masc_fem_pron	12429
He has three interceptions to lead the Giants .	She has three interceptions to lead the Giants .	masc_fem_pron	25543
He was awarded $ 8 million .	She was awarded $ 8 million .	masc_fem_pron	7621
When he did , there were still problems .	When she did , there were still problems .	masc_fem_pron	3362
That is why he is considering early retirement .	That is why she is considering early retirement .	masc_fem_pron	13769
And now people come to see him .	And now people come to see her .	masc_fem_pron	17588
He is just learned that Pilates can add an inch to your height .	She is just learned that Pilates can add an inch to your height .	masc_fem_pron	15800
He has made 19 of 20 this season .	She has made 19 of 20 this season .	masc_fem_pron	10647
He also helped Canada win the silver medal in 1992 .	She also helped Canada win the silver medal in 1992 .	masc_fem_pron	19274
He has all the tools to succeed somewhere .	She has all the tools to succeed somewhere .	masc_fem_pron	25686
Eventually , he had enough .	Eventually , she had enough .	masc_fem_pron	31050
He can go and watch that mob FC United .	She can go and watch that mob FC United .	masc_fem_pron	8392
He advised them to say no guns were involved .	She advised them to say no guns were involved .	masc_fem_pron	5594
He also holds the postseason record with 34 saves .	She also holds the postseason record with 34 saves .	masc_fem_pron	13149
He also complained about Israeli army checkpoints in the West Bank .	She also complained about Israeli army checkpoints in the West Bank .	masc_fem_pron	5969
He is married with three children .	She is married with three children .	masc_fem_pron	28233
But he did not look happy .	But she did not look happy .	masc_fem_pron	21024
" These attacks were totally unprovoked , " he said .	" These attacks were totally unprovoked , " she said .	masc_fem_pron	12730
He said the two had strong incentives to work closely together .	She said the two had strong incentives to work closely together .	masc_fem_pron	32873
He knows someone at the local hospital in Rangoon .	She knows someone at the local hospital in Rangoon .	masc_fem_pron	18936
He did not go into details .	She did not go into details .	masc_fem_pron	25023
He still has time .	She still has time .	masc_fem_pron	33208
He later returned to the game .	She later returned to the game .	masc_fem_pron	33791
He was killed in Iraq in 2003 .	She was killed in Iraq in 2003 .	masc_fem_pron	14632
Clinton has long resisted attempts to psychoanalyze him from afar .	Clinton has long resisted attempts to psychoanalyze her from afar .	masc_fem_pron	21245
He would lost a lot of weight and was ready to go .	She would lost a lot of weight and was ready to go .	masc_fem_pron	27997
He made bad decisions , plagiarizing a college paper and behaving promiscuously .	She made bad decisions , plagiarizing a college paper and behaving promiscuously .	masc_fem_pron	9674
He was a man with an international view .	She was a man with an international view .	masc_fem_pron	28800
The chief inspector warned him against making the bribe .	The chief inspector warned her against making the bribe .	masc_fem_pron	32664
He also gained 40 yards on five rushes .	She also gained 40 yards on five rushes .	masc_fem_pron	27000
He wrote several books on DNA and biotechnology .	She wrote several books on DNA and biotechnology .	masc_fem_pron	26923
" Life is not perfect , " he added .	" Life is not perfect , " she added .	masc_fem_pron	12971
He resigned from the force after being found out .	She resigned from the force after being found out .	masc_fem_pron	3256
11 , he has since presided over every midnight Mass there .	11 , she has since presided over every midnight Mass there .	masc_fem_pron	2676
The only difference now is that he is living there .	The only difference now is that she is living there .	masc_fem_pron	28180
" You could almost touch them , " he says .	" You could almost touch them , " she says .	masc_fem_pron	21219
A few days later , Julie contacted him .	A few days later , Julie contacted her .	masc_fem_pron	29108
" You wanted early elections , " he said .	" You wanted early elections , " she said .	masc_fem_pron	17426
There are even fears he could defect to the government bloc .	There are even fears she could defect to the government bloc .	masc_fem_pron	25678
He looked like a carny .	She looked like a carny .	masc_fem_pron	1776
But he is also a true freshman .	But she is also a true freshman .	masc_fem_pron	11158
He has become a cause celebre in France .	She has become a cause celebre in France .	masc_fem_pron	26759
He supports intensive phonics instruction for young readers who need help .	She supports intensive phonics instruction for young readers who need help .	masc_fem_pron	17532
He offers a quick jab at the critics .	She offers a quick jab at the critics .	masc_fem_pron	19179
He had always been an outgoing , forthright chap , a high-speed driver .	She had always been an outgoing , forthright chap , a high-speed driver .	masc_fem_pron	27251
He wore a duffle jacket and either jeans or jogging trousers .	She wore a duffle jacket and either jeans or jogging trousers .	masc_fem_pron	33246
But he did not have enough .	But she did not have enough .	masc_fem_pron	26400
He also made a wild throw in that game .	She also made a wild throw in that game .	masc_fem_pron	12071
He eats in a rubber tub at knee level .	She eats in a rubber tub at knee level .	masc_fem_pron	16646
Then he was whisked away by bodyguards and disappeared .	Then she was whisked away by bodyguards and disappeared .	masc_fem_pron	3953
He goes for the big tune at every opportunity .	She goes for the big tune at every opportunity .	masc_fem_pron	19208
He will think about tennis later .	She will think about tennis later .	masc_fem_pron	28825
He points to increasingly attractive valuations for large-cap blue chips .	She points to increasingly attractive valuations for large-cap blue chips .	masc_fem_pron	18999
He deserves this one .	She deserves this one .	masc_fem_pron	25371
He represented Al Gore in the disputed 2000 presidential election .	She represented Al Gore in the disputed 2000 presidential election .	masc_fem_pron	20524
By night , he was dead .	By night , she was dead .	masc_fem_pron	32194
He has nothing .	She has nothing .	masc_fem_pron	13874
He never boasted about anything .	She never boasted about anything .	masc_fem_pron	22489
He might even kill you .	She might even kill you .	masc_fem_pron	8080
But he surely would have approved .	But she surely would have approved .	masc_fem_pron	24843
" The firemen were so great , " he said .	" The firemen were so great , " she said .	masc_fem_pron	3994
He was identified as Constance Russell , 57 , of Los Angeles .	She was identified as Constance Russell , 57 , of Los Angeles .	masc_fem_pron	19972
But , boy , can he tackle .	But , boy , can she tackle .	masc_fem_pron	29641
He always uses that word .	She always uses that word .	masc_fem_pron	7853
He regularly fronted current affairs programmes and documentaries .	She regularly fronted current affairs programmes and documentaries .	masc_fem_pron	5212
He did not disclose the amount .	She did not disclose the amount .	masc_fem_pron	2129
He was arrested on suspicion of attempted murder , Ms Oliver said .	She was arrested on suspicion of attempted murder , Ms Oliver said .	masc_fem_pron	33189
He became assistant controller in 2004 .	She became assistant controller in 2004 .	masc_fem_pron	6927
He would not be disappointed .	She would not be disappointed .	masc_fem_pron	12240
He cannot .	She cannot .	masc_fem_pron	14738
He was first elected to the Senate in 1972 .	She was first elected to the Senate in 1972 .	masc_fem_pron	15341
" You do not start where you finish , " he said .	" You do not start where you finish , " she said .	masc_fem_pron	15665
He lasted five innings and scattered two hits .	She lasted five innings and scattered two hits .	masc_fem_pron	25503
Anything he does is interpreted in a certain way .	Anything she does is interpreted in a certain way .	masc_fem_pron	1707
He is already tired .	She is already tired .	masc_fem_pron	30506
He is now 28 points behind series leader Jeff Gordon .	She is now 28 points behind series leader Jeff Gordon .	masc_fem_pron	8447
Authorities evacuated 359 miners , and 19 were hospitalised , he said .	Authorities evacuated 359 miners , and 19 were hospitalised , she said .	masc_fem_pron	28606
Roddick insists he is now fully fit .	Roddick insists she is now fully fit .	masc_fem_pron	31125
He is also paralysed down one side .	She is also paralysed down one side .	masc_fem_pron	5156
He is survived by Viertel , two daughters and three grandchildren .	She is survived by Viertel , two daughters and three grandchildren .	masc_fem_pron	29086
He is banned from hearing confessions but can still celebrate Mass .	She is banned from hearing confessions but can still celebrate Mass .	masc_fem_pron	22993
He obviously had a thing for Spenser .	She obviously had a thing for Spenser .	masc_fem_pron	22637
He died in 2006 .	She died in 2006 .	masc_fem_pron	29188
He said LambdaRail needed additional concessions to satisfy its obligations to contributing members .	She said LambdaRail needed additional concessions to satisfy its obligations to contributing members .	masc_fem_pron	13604
He was 87 and lived in Manhattan .	She was 87 and lived in Manhattan .	masc_fem_pron	26902
He speaks with a Midlands accent .	She speaks with a Midlands accent .	masc_fem_pron	20265
Gravel says he would be honored .	Gravel says she would be honored .	masc_fem_pron	23643
Jacksonville waived him on Sunday .	Jacksonville waived her on Sunday .	masc_fem_pron	7266
Time-travel narratives come much closer , he thinks .	Time-travel narratives come much closer , she thinks .	masc_fem_pron	20753
He was 13 of 26 for 98 yards and an interception .	She was 13 of 26 for 98 yards and an interception .	masc_fem_pron	798
When he was a kid .	When she was a kid .	masc_fem_pron	2976
He survived by jumping out of the truck .	She survived by jumping out of the truck .	masc_fem_pron	31798
He beamed .	She beamed .	masc_fem_pron	32001
" They are jealous , " he said with a smile .	" They are jealous , " she said with a smile .	masc_fem_pron	12812
He was in Syria with Bilal , bound for Iraq .	She was in Syria with Bilal , bound for Iraq .	masc_fem_pron	22874
But he never quite succeeds .	But she never quite succeeds .	masc_fem_pron	26067
Rodgers is indifferent to those who question him .	Rodgers is indifferent to those who question her .	masc_fem_pron	32223
He is that good .	She is that good .	masc_fem_pron	28026
Wilkinson said he could not comment .	Wilkinson said she could not comment .	masc_fem_pron	15131
He is trying to get to another level right now .	She is trying to get to another level right now .	masc_fem_pron	6769
He said EDF Energy apologises to all affected customers for any inconvenience caused .	She said EDF Energy apologises to all affected customers for any inconvenience caused .	masc_fem_pron	32821
He is quiet and unassuming .	She is quiet and unassuming .	masc_fem_pron	22989
" This is a very secure building , " he said .	" This is a very secure building , " she said .	masc_fem_pron	11924
He had been on provisional release in Croatia since December 2004 .	She had been on provisional release in Croatia since December 2004 .	masc_fem_pron	29021
" He is not stable , " Poston said .	" She is not stable , " Poston said .	masc_fem_pron	3219
He will play catch today .	She will play catch today .	masc_fem_pron	13983
Here 's what he needs to do .	Here 's what she needs to do .	masc_fem_pron	32784
The team said he is day-to-day .	The team said she is day-to-day .	masc_fem_pron	31673
He married the writer and translator Tibor Szobotka in 1947 .	She married the writer and translator Tibor Szobotka in 1947 .	masc_fem_pron	22722
He loves to compete .	She loves to compete .	masc_fem_pron	24958
" He goes , ' Yeah , you did .	" She goes , ' Yeah , you did .	masc_fem_pron	6145
He sounded serious .	She sounded serious .	masc_fem_pron	20411
He found them all struggling to hire and retain workers .	She found them all struggling to hire and retain workers .	masc_fem_pron	27656
They then drove away , he said .	They then drove away , she said .	masc_fem_pron	24167
He had a lot of Ks today .	She had a lot of Ks today .	masc_fem_pron	18784
The risk of misidentification was a major concern , he said .	The risk of misidentification was a major concern , she said .	masc_fem_pron	19974
He has volunteered for the Red Cross .	She has volunteered for the Red Cross .	masc_fem_pron	8562
" He really had no bitterness whatsoever , " Upshaw says .	" She really had no bitterness whatsoever , " Upshaw says .	masc_fem_pron	32490
He gave no indication that Cao was forthcoming .	She gave no indication that Cao was forthcoming .	masc_fem_pron	15958
There was something familiar about him .	There was something familiar about her .	masc_fem_pron	24447
There were reports all summer that he was leaving .	There were reports all summer that she was leaving .	masc_fem_pron	21090
He has missed a paper , daily warm-ups , quizzes .	She has missed a paper , daily warm-ups , quizzes .	masc_fem_pron	34333
And he would cheerfully demonstrate the method .	And she would cheerfully demonstrate the method .	masc_fem_pron	15055
He was appointed CB in 1989 .	She was appointed CB in 1989 .	masc_fem_pron	24944
The pet died in the blaze , he said .	The pet died in the blaze , she said .	masc_fem_pron	26496
He built a 20-foot half-pipe in their backyard .	She built a 20-foot half-pipe in their backyard .	masc_fem_pron	32505
He joined the west London club in 2001 from West Ham .	She joined the west London club in 2001 from West Ham .	masc_fem_pron	16224
A spokeswoman for Aramark said he was unaware of the case .	A spokeswoman for Aramark said she was unaware of the case .	masc_fem_pron	18081
" Nobody wants war , " he says .	" Nobody wants war , " she says .	masc_fem_pron	5327
He asked a lot of open-ended questions .	She asked a lot of open-ended questions .	masc_fem_pron	18942
He resigned in October 2004 .	She resigned in October 2004 .	masc_fem_pron	33776
He will face 11 challengers .	She will face 11 challengers .	masc_fem_pron	13981
" This is awesome , " he said .	" This is awesome , " she said .	masc_fem_pron	30416
No , he does not rap .	No , she does not rap .	masc_fem_pron	16375
He is trying to eradicate malaria .	She is trying to eradicate malaria .	masc_fem_pron	32084
He walked four and struck out one .	She walked four and struck out one .	masc_fem_pron	13553
He designed , too .	She designed , too .	masc_fem_pron	3407
He has three children from a previous marriage .	She has three children from a previous marriage .	masc_fem_pron	9742
He finished the game with 196 yards .	She finished the game with 196 yards .	masc_fem_pron	25481
He had shoulder-length brown hair and had an unkempt appearance .	She had shoulder-length brown hair and had an unkempt appearance .	masc_fem_pron	17024
" Facebook is everyone 's darling today , " he said .	" Facebook is everyone 's darling today , " she said .	masc_fem_pron	3667
And he warned that America should cease propping up General Musharraf .	And she warned that America should cease propping up General Musharraf .	masc_fem_pron	7529
" The Soviet Union is gone , " he affirmed .	" The Soviet Union is gone , " she affirmed .	masc_fem_pron	27334
He said a rocket-propelled grenade exploded near the shrine .	She said a rocket-propelled grenade exploded near the shrine .	masc_fem_pron	7009
Luckily he has an idea .	Luckily she has an idea .	masc_fem_pron	16826
He also gained 48 yards on seven carries .	She also gained 48 yards on seven carries .	masc_fem_pron	29089
He said the shortcomings contrasted with assurances made by the company .	She said the shortcomings contrasted with assurances made by the company .	masc_fem_pron	7886
But he would have liked that part about creating issues .	But she would have liked that part about creating issues .	masc_fem_pron	30625
So does he .	So does she .	masc_fem_pron	30953
He now has three consecutive 100-yard games dating to last season .	She now has three consecutive 100-yard games dating to last season .	masc_fem_pron	7606
Now , he must win a couple playoff games .	Now , she must win a couple playoff games .	masc_fem_pron	4548
He also will probably sit out Sunday .	She also will probably sit out Sunday .	masc_fem_pron	26907
He was charged with first-degree murder and several other crimes .	She was charged with first-degree murder and several other crimes .	masc_fem_pron	11974
He also vowed to tell the truth always as president .	She also vowed to tell the truth always as president .	masc_fem_pron	3336
Before that , he led the Football Association .	Before that , she led the Football Association .	masc_fem_pron	23664
But he also made friends with other artists .	But she also made friends with other artists .	masc_fem_pron	28769
Before that , he had gone 10 games without a goal .	Before that , she had gone 10 games without a goal .	masc_fem_pron	34441
He is the Travel King !	She is the Travel King !	masc_fem_pron	10006
He finished with 25 saves .	She finished with 25 saves .	masc_fem_pron	4879
He has a 10.19 ERA during that stretch .	She has a 10.19 ERA during that stretch .	masc_fem_pron	24049
You cannot typecast him .	You cannot typecast her .	masc_fem_pron	33382
He could not remember ever liking Lego .	She could not remember ever liking Lego .	masc_fem_pron	24550
" Everyone 's grown-ups here to play rugby , " he said .	" Everyone 's grown-ups here to play rugby , " she said .	masc_fem_pron	16745
He worked sporadically as a translator .	She worked sporadically as a translator .	masc_fem_pron	24853
He said Beckworth had previously threatened to harm Lee .	She said Beckworth had previously threatened to harm Lee .	masc_fem_pron	25416
He argued for secure borders .	She argued for secure borders .	masc_fem_pron	22082
He said a feasibility study might be conducted .	She said a feasibility study might be conducted .	masc_fem_pron	26041
He works very hard .	She works very hard .	masc_fem_pron	12485
He was always a replicant .	She was always a replicant .	masc_fem_pron	32176
But he noted that the 10-week trial was extraordinary .	But she noted that the 10-week trial was extraordinary .	masc_fem_pron	4591
He was 0-17 in games in which the Huskers trailed at halftime .	She was 0-17 in games in which the Huskers trailed at halftime .	masc_fem_pron	23444
He was certainly not involved in anything illegal .	She was certainly not involved in anything illegal .	masc_fem_pron	21569
" There is plenty of money in the system , " he said .	" There is plenty of money in the system , " she said .	masc_fem_pron	11129
He declined to provide further details .	She declined to provide further details .	masc_fem_pron	6631
But he denied the planned unitary council had influenced the decision .	But she denied the planned unitary council had influenced the decision .	masc_fem_pron	27409
He would benefit from practice , yes .	She would benefit from practice , yes .	masc_fem_pron	8796
Many expected him to fail utterly .	Many expected her to fail utterly .	masc_fem_pron	2025
Today he did just fine .	Today she did just fine .	masc_fem_pron	15879
He got a busy signal .	She got a busy signal .	masc_fem_pron	33230
He was led out of the courtroom in handcuffs .	She was led out of the courtroom in handcuffs .	masc_fem_pron	5688
The army alone needs 10,000 MRAPs , he said .	The army alone needs 10,000 MRAPs , she said .	masc_fem_pron	4646
He had never sounded more like Mr Mackay .	She had never sounded more like Mr Mackay .	masc_fem_pron	30105
" This is big , " he said .	" This is big , " she said .	masc_fem_pron	13673
Before they even held their newborn baby , doctors whisked him away .	Before they even held their newborn baby , doctors whisked her away .	masc_fem_pron	28881
" This was a wholesale breach of trust , " he added .	" This was a wholesale breach of trust , " she added .	masc_fem_pron	32238
He was partially-clothed and under a duvet .	She was partially-clothed and under a duvet .	masc_fem_pron	21432
He later died at a nearby hospital .	She later died at a nearby hospital .	masc_fem_pron	28810
He cared about poor and working people .	She cared about poor and working people .	masc_fem_pron	14794
He can also post jeans to your home address .	She can also post jeans to your home address .	masc_fem_pron	24977
He declined to identify the buyer .	She declined to identify the buyer .	masc_fem_pron	27592
He had been stabbed in the neck and later died in hospital .	She had been stabbed in the neck and later died in hospital .	masc_fem_pron	6699
He died a week later .	She died a week later .	masc_fem_pron	413
He has not heard from Faldo since the furore .	She has not heard from Faldo since the furore .	masc_fem_pron	33278
He struck out six and walked two .	She struck out six and walked two .	masc_fem_pron	27528
He was extradited to the United States in 2006 .	She was extradited to the United States in 2006 .	masc_fem_pron	1073
So he took them to Los Angeles .	So she took them to Los Angeles .	masc_fem_pron	15326
He had been charged with conspiracy to rob , and other offences .	She had been charged with conspiracy to rob , and other offences .	masc_fem_pron	20575
He also reserved the right to respond aggressively .	She also reserved the right to respond aggressively .	masc_fem_pron	15150
Unlikely , say those who know him .	Unlikely , say those who know her .	masc_fem_pron	2696
He is one hell of a tall candidate .	She is one hell of a tall candidate .	masc_fem_pron	17119
" They are just gutted , " he said .	" They are just gutted , " she said .	masc_fem_pron	33941
" " He has a heart , a spiritual heart .	" " She has a heart , a spiritual heart .	masc_fem_pron	11499
" They 'll send a mechanic , " he answered .	" They 'll send a mechanic , " she answered .	masc_fem_pron	5806
But he will not last long .	But she will not last long .	masc_fem_pron	23931
But he said the goals were still worth pursuing .	But she said the goals were still worth pursuing .	masc_fem_pron	12642
He went on to compete in 69 races , scoring 45 points .	She went on to compete in 69 races , scoring 45 points .	masc_fem_pron	4128
He looks sure to be re-elected unless last-ditch court challenges succeed .	She looks sure to be re-elected unless last-ditch court challenges succeed .	masc_fem_pron	6201
Later , he was diagnosed with allergies .	Later , she was diagnosed with allergies .	masc_fem_pron	10898
He did precisely that .	She did precisely that .	masc_fem_pron	11447
He is seduced by Kissinger 's Scheherazade tales of power .	She is seduced by Kissinger 's Scheherazade tales of power .	masc_fem_pron	11234
He is smart and capable and witty .	She is smart and capable and witty .	masc_fem_pron	14019
He told two guidance counselors .	She told two guidance counselors .	masc_fem_pron	25997
And then he let them play , loudly .	And then she let them play , loudly .	masc_fem_pron	4214
He mentions the FAA air-traffic control network as an example .	She mentions the FAA air-traffic control network as an example .	masc_fem_pron	17382
He became involved in the civil rights movement , protesting segregation .	She became involved in the civil rights movement , protesting segregation .	masc_fem_pron	33476
He is free on $ 20,000 bail .	She is free on $ 20,000 bail .	masc_fem_pron	12338
He finally got home last week .	She finally got home last week .	masc_fem_pron	13487
He shows the Mexican couple a chromosome chart .	She shows the Mexican couple a chromosome chart .	masc_fem_pron	27746
He is learned a lot about autism .	She is learned a lot about autism .	masc_fem_pron	5533
He was treated at hospital for facial injuries before being questioned by police .	She was treated at hospital for facial injuries before being questioned by police .	masc_fem_pron	34650
You have to ask him .	You have to ask her .	masc_fem_pron	32513
" Yes , he was , " Lloyd replies .	" Yes , she was , " Lloyd replies .	masc_fem_pron	21458
He was suspended .	She was suspended .	masc_fem_pron	17052
He was named for Washoe County , Nev .	She was named for Washoe County , Nev .	masc_fem_pron	15057
" This means everything is okay , " he purred .	" This means everything is okay , " she purred .	masc_fem_pron	25528
He has yet to do so .	She has yet to do so .	masc_fem_pron	23525
He has pleaded not guilty to the charges .	She has pleaded not guilty to the charges .	masc_fem_pron	5395
He is meeting Cosla tomorrow .	She is meeting Cosla tomorrow .	masc_fem_pron	6261
He responded eloquently .	She responded eloquently .	masc_fem_pron	4125
But throughout he undercuts the claims of that old world .	But throughout she undercuts the claims of that old world .	masc_fem_pron	29335
He married Ms. Mantovani in 2003 .	She married Ms. Mantovani in 2003 .	masc_fem_pron	27337
He lectured at Dartmouth , Harvard and Princeton - and the State Department .	She lectured at Dartmouth , Harvard and Princeton - and the State Department .	masc_fem_pron	25028
He had suffered a hypoglycaemic coma and died the following morning .	She had suffered a hypoglycaemic coma and died the following morning .	masc_fem_pron	12984
He said the donor company was based in the UK .	She said the donor company was based in the UK .	masc_fem_pron	1332
The programme could founder without the technology , he said .	The programme could founder without the technology , she said .	masc_fem_pron	34521
He had the remaining frozen embryos implanted , and had twins .	She had the remaining frozen embryos implanted , and had twins .	masc_fem_pron	18032
He was being kept in hospital for monitoring .	She was being kept in hospital for monitoring .	masc_fem_pron	27304
" He would probably go crazy , " Betterton said .	" She would probably go crazy , " Betterton said .	masc_fem_pron	30984
He said several policemen died .	She said several policemen died .	masc_fem_pron	21235
He had further stipulations .	She had further stipulations .	masc_fem_pron	22495
Most are single first-time buyers in their 20s and 30s , he said .	Most are single first-time buyers in their 20s and 30s , she said .	masc_fem_pron	27005
He was wearing a Michael Vick jersey , the shamed No. 7 .	She was wearing a Michael Vick jersey , the shamed No. 7 .	masc_fem_pron	8297
Mr Saakashvili sacked him last year .	Mr Saakashvili sacked her last year .	masc_fem_pron	9429
He is a sex symbol who wrote a best seller .	She is a sex symbol who wrote a best seller .	masc_fem_pron	1401
" He had such good taste , " one woman said .	" She had such good taste , " one woman said .	masc_fem_pron	25501
Still , he expects to hear cheers Thursday .	Still , she expects to hear cheers Thursday .	masc_fem_pron	17006
He only picked out Jayawardene .	She only picked out Jayawardene .	masc_fem_pron	21732
And he is in second place in New Hampshire .	And she is in second place in New Hampshire .	masc_fem_pron	21082
VICTORIA 'S worried that Geri is thinner than him .	VICTORIA 'S worried that Geri is thinner than her .	masc_fem_pron	15383
Desperate , he moved in late summer .	Desperate , she moved in late summer .	masc_fem_pron	21234
He added that sales of children 's clothing fared unusually well Friday .	She added that sales of children 's clothing fared unusually well Friday .	masc_fem_pron	16182
He is not that bad , either .	She is not that bad , either .	masc_fem_pron	8189
He was three months old .	She was three months old .	masc_fem_pron	13715
He also agreed to register as a sex offender .	She also agreed to register as a sex offender .	masc_fem_pron	22700
Bush wants you to know he is not Bill Clinton .	Bush wants you to know she is not Bill Clinton .	masc_fem_pron	13585
The next morning he came up with a plan .	The next morning she came up with a plan .	masc_fem_pron	23611
He was never charged with an offense .	She was never charged with an offense .	masc_fem_pron	8595
Something about that man is wrong , he thought .	Something about that man is wrong , she thought .	masc_fem_pron	21492
He then proceeded to use tons of hairspray as well .	She then proceeded to use tons of hairspray as well .	masc_fem_pron	25280
He starts adding up points , then frowns .	She starts adding up points , then frowns .	masc_fem_pron	31621
He had three brain M.R.I. ' s .	She had three brain M.R.I. ' s .	masc_fem_pron	20288
He is married with a son and daughter .	She is married with a son and daughter .	masc_fem_pron	33070
He is cruised to 1 : 14.949 .	She is cruised to 1 : 14.949 .	masc_fem_pron	7517
An Internet search led him to Ballet Magnificat !	An Internet search led her to Ballet Magnificat !	masc_fem_pron	557
He was there to shop .	She was there to shop .	masc_fem_pron	30852
He was humble .	She was humble .	masc_fem_pron	15921
He had no other details .	She had no other details .	masc_fem_pron	3211
He deserves better than this .	She deserves better than this .	masc_fem_pron	21146
He was prime minister for the first time from 2000 until 2001 .	She was prime minister for the first time from 2000 until 2001 .	masc_fem_pron	25694
He would not hurt anyone .	She would not hurt anyone .	masc_fem_pron	14572
This was a good thing , he explained .	This was a good thing , she explained .	masc_fem_pron	19904
He has been the ABCNEWS.com Silicon Insider columnist since 2000 .	She has been the ABCNEWS.com Silicon Insider columnist since 2000 .	masc_fem_pron	11174
" He did not eat meat , " Stahl said .	" She did not eat meat , " Stahl said .	masc_fem_pron	3087
He was also on two other immune-suppressing drugs .	She was also on two other immune-suppressing drugs .	masc_fem_pron	17983
He has recovered well .	She has recovered well .	masc_fem_pron	5955
" Raila 's absolutely beautiful , " he said .	" Raila 's absolutely beautiful , " she said .	masc_fem_pron	12890
He said the group was scheduled to return to California on Christmas Eve .	She said the group was scheduled to return to California on Christmas Eve .	masc_fem_pron	1532
He laughed at the thought .	She laughed at the thought .	masc_fem_pron	32660
He wanted a non-relative .	She wanted a non-relative .	masc_fem_pron	20705
He does not wander the streets alone at night anymore .	She does not wander the streets alone at night anymore .	masc_fem_pron	15791
He also was fined $ 600 and ordered to get counseling .	She also was fined $ 600 and ordered to get counseling .	masc_fem_pron	21925
He is the last enemy you 'd ever want to see .	She is the last enemy you 'd ever want to see .	masc_fem_pron	27542
He comes to a page that lists Troy 's problems .	She comes to a page that lists Troy 's problems .	masc_fem_pron	3685
He said the arrest was not connected to Wednesday 's shooting .	She said the arrest was not connected to Wednesday 's shooting .	masc_fem_pron	6776
He was being held in lieu of $ 1 million bail .	She was being held in lieu of $ 1 million bail .	masc_fem_pron	11367
He denied any involvement in either woman 's death .	She denied any involvement in either woman 's death .	masc_fem_pron	564
He believes that establishing the reserve is just one link in the chain .	She believes that establishing the reserve is just one link in the chain .	masc_fem_pron	15242
He is a former member of the party 's Senate leadership .	She is a former member of the party 's Senate leadership .	masc_fem_pron	11475
Reporters asked how he felt .	Reporters asked how she felt .	masc_fem_pron	878
... he will come back and make great music .	... she will come back and make great music .	masc_fem_pron	5960
He suggested that people probably would not turn on their lights more often .	She suggested that people probably would not turn on their lights more often .	masc_fem_pron	2257
Dickinson said Solomon never said those words to him .	Dickinson said Solomon never said those words to her .	masc_fem_pron	26360
He was unable to find one on the market .	She was unable to find one on the market .	masc_fem_pron	20502
He goes out there and makes four .	She goes out there and makes four .	masc_fem_pron	17470
News that he is wanted in Japan .	News that she is wanted in Japan .	masc_fem_pron	5968
Significantly , he never swept Murali .	Significantly , she never swept Murali .	masc_fem_pron	25221
When he was 16 , education officials recommended Rotenberg .	When she was 16 , education officials recommended Rotenberg .	masc_fem_pron	3031
A few weeks later he died .	A few weeks later she died .	masc_fem_pron	25618
He is now progressed to injecting more interesting " cocktails " like speedballs .	She is now progressed to injecting more interesting " cocktails " like speedballs .	masc_fem_pron	4070
But he had to think twice .	But she had to think twice .	masc_fem_pron	28022
He 'll stay within the system .	She 'll stay within the system .	masc_fem_pron	9198
Soon he began pondering a commercial venture .	Soon she began pondering a commercial venture .	masc_fem_pron	12183
He was never much of a man about town .	She was never much of a man about town .	masc_fem_pron	18360
He currently gives private ballet lessons for children .	She currently gives private ballet lessons for children .	masc_fem_pron	22941
" The crackdown has been brutal , " he told the newspaper .	" The crackdown has been brutal , " she told the newspaper .	masc_fem_pron	18423
He wrote one about health care for children .	She wrote one about health care for children .	masc_fem_pron	26368
But he never signed the quitclaim deed .	But she never signed the quitclaim deed .	masc_fem_pron	23335
Death certainly seemed to obsess him .	Death certainly seemed to obsess her .	masc_fem_pron	2148
In all , he spent 57 seconds in the chamber .	In all , she spent 57 seconds in the chamber .	masc_fem_pron	26281
He was assigned to the National Guard 's 275th Military Police Company .	She was assigned to the National Guard 's 275th Military Police Company .	masc_fem_pron	33491
" There has been no last-minute change , " he told reporters .	" There has been no last-minute change , " she told reporters .	masc_fem_pron	31180
Then he would leap into the water .	Then she would leap into the water .	masc_fem_pron	30798
The results proved him right .	The results proved her right .	masc_fem_pron	9975
He had 147 yards and 3 touchdowns .	She had 147 yards and 3 touchdowns .	masc_fem_pron	8863
He needs a lot of love .	She needs a lot of love .	masc_fem_pron	27109
Since then he has released a total of twenty-one albums .	Since then she has released a total of twenty-one albums .	masc_fem_pron	26226
He denies that there has been any shillyshallying .	She denies that there has been any shillyshallying .	masc_fem_pron	25119
He is been smoke-free for almost a year .	She is been smoke-free for almost a year .	masc_fem_pron	5342
" He is a mature , young guy , " Connolly said .	" She is a mature , young guy , " Connolly said .	masc_fem_pron	32213
Yet he speaks of Nureyev with undying devotion .	Yet she speaks of Nureyev with undying devotion .	masc_fem_pron	4698
" They 've been around 130 years , " he said .	" They 've been around 130 years , " she said .	masc_fem_pron	33005
" He is going to be excited enough , " Brown said .	" She is going to be excited enough , " Brown said .	masc_fem_pron	30683
He also has formed JPA Partners , a consulting company .	She also has formed JPA Partners , a consulting company .	masc_fem_pron	8709
New Orleans grounds him .	New Orleans grounds her .	masc_fem_pron	31382
He has a major league-leading 221 strikeouts .	She has a major league-leading 221 strikeouts .	masc_fem_pron	30138
" Businesses have the power to do good , " he wrote .	" Businesses have the power to do good , " she wrote .	masc_fem_pron	34020
He is expected to miss six weeks .	She is expected to miss six weeks .	masc_fem_pron	2725
" He is a superstar horse , " Bejarano said .	" She is a superstar horse , " Bejarano said .	masc_fem_pron	15252
Police had detained him there since Tuesday .	Police had detained her there since Tuesday .	masc_fem_pron	19798
But he is a force of nature .	But she is a force of nature .	masc_fem_pron	15669
He said the disc is due out December 11 .	She said the disc is due out December 11 .	masc_fem_pron	30095
" That is a very good question , " he said .	" That is a very good question , " she said .	masc_fem_pron	3852
On the other hand , he will have a lot of money .	On the other hand , she will have a lot of money .	masc_fem_pron	2978
He has not played since Nov. 30 .	She has not played since Nov. 30 .	masc_fem_pron	26306
He is from Ljubljana , in Slovenia .	She is from Ljubljana , in Slovenia .	masc_fem_pron	5831
He was told to return Dec. 5 .	She was told to return Dec. 5 .	masc_fem_pron	11697
" The state will defend the lawsuit , " he said .	" The state will defend the lawsuit , " she said .	masc_fem_pron	22940
He was not joking .	She was not joking .	masc_fem_pron	28907
He would be scratched , punched , kneed and bitten .	She would be scratched , punched , kneed and bitten .	masc_fem_pron	20749
Another policeman was missing , he said .	Another policeman was missing , she said .	masc_fem_pron	31531
He is survived by a sister , Muriel , of Largo , Fla .	She is survived by a sister , Muriel , of Largo , Fla .	masc_fem_pron	16720
He is an enthusiastic , energetic addition to the board .	She is an enthusiastic , energetic addition to the board .	masc_fem_pron	24198
He talked for 15 minutes but cleared up next to nothing .	She talked for 15 minutes but cleared up next to nothing .	masc_fem_pron	31094
5 when he was pitching on three days ' rest .	5 when she was pitching on three days ' rest .	masc_fem_pron	22650
He was always sleeping .	She was always sleeping .	masc_fem_pron	13980
He has a reputation for charging for autographs .	She has a reputation for charging for autographs .	masc_fem_pron	31922
He has a lot of integrity .	She has a lot of integrity .	masc_fem_pron	26905
He had been admitted suffering from abdominal pain and vomiting .	She had been admitted suffering from abdominal pain and vomiting .	masc_fem_pron	25197
At no point did he become defensive or uncooperative .	At no point did she become defensive or uncooperative .	masc_fem_pron	8757
But he has foundered in polls .	But she has foundered in polls .	masc_fem_pron	12594
He was 77 .	She was 77 .	masc_fem_pron	11521
He , too , faces a younger , more charismatic threat .	She , too , faces a younger , more charismatic threat .	masc_fem_pron	9039
He is no stranger to the small screen .	She is no stranger to the small screen .	masc_fem_pron	1199
He would never heard of a mammogram or mastectomy .	She would never heard of a mammogram or mastectomy .	masc_fem_pron	11637
He was smoking .	She was smoking .	masc_fem_pron	6570
He resigned a month later as district attorney .	She resigned a month later as district attorney .	masc_fem_pron	96
Massey said he supported the decision .	Massey said she supported the decision .	masc_fem_pron	29490
He holds an MBA degree from Loyola University of Chicago .	She holds an MBA degree from Loyola University of Chicago .	masc_fem_pron	16892
The fire was intentionally set , he said .	The fire was intentionally set , she said .	masc_fem_pron	9783
Replacing him was Reuben Droughns .	Replacing her was Reuben Droughns .	masc_fem_pron	19432
He is fluent in Portuguese , Spanish and English .	She is fluent in Portuguese , Spanish and English .	masc_fem_pron	33436
He changes the subject .	She changes the subject .	masc_fem_pron	22881
Don 't call this useless , he insisted .	Don 't call this useless , she insisted .	masc_fem_pron	18175
But he was cold in the second half .	But she was cold in the second half .	masc_fem_pron	2400
Byrne said he is aware that much work remains .	Byrne said she is aware that much work remains .	masc_fem_pron	27343
He will continue at domestic level .	She will continue at domestic level .	masc_fem_pron	8926
He was an excellent robotics operator .	She was an excellent robotics operator .	masc_fem_pron	22269
He is now a goalkeeping coach at Oxford United .	She is now a goalkeeping coach at Oxford United .	masc_fem_pron	13226
And he prefers not to even try .	And she prefers not to even try .	masc_fem_pron	1609
He has already started shedding skins .	She has already started shedding skins .	masc_fem_pron	21466
He is enjoying the production .	She is enjoying the production .	masc_fem_pron	2495
He noted Petraeus 's report respectfully .	She noted Petraeus 's report respectfully .	masc_fem_pron	19478
Years on , the strain would also take its toll on him .	Years on , the strain would also take its toll on her .	masc_fem_pron	34379
He did not need any notes for those occasions , either .	She did not need any notes for those occasions , either .	masc_fem_pron	8525
He can call upon the Legislature for help .	She can call upon the Legislature for help .	masc_fem_pron	29385
" They are not on a political suicide mission , " he said .	" They are not on a political suicide mission , " she said .	masc_fem_pron	24717
