You get a response .	You will get a response .	pres_fut	0
We kill him in return !	We will kill him in return !	pres_fut	1
At the moment I say I am keeping my powder dry .	At the moment I will say I am keeping my powder dry .	pres_fut	2
" I hope they release them all tomorrow , " he said .	" I hope they will release them all tomorrow , " he said .	pres_fut	3
Hopefully we see a bit of that .	Hopefully we will see a bit of that .	pres_fut	4
We go home and organize .	We will go home and organize .	pres_fut	6
They find her .	They will find her .	pres_fut	7
Both countries stress that they remain allies .	Both countries stress that they will remain allies .	pres_fut	8
We make use of them if required .	We will make use of them if required .	pres_fut	11
I have not yet decided whether I vote .	I have not yet decided whether I will vote .	pres_fut	15
" " We confront this danger before it is too late .	" " We will confront this danger before it is too late .	pres_fut	16
They listen to their favourite players .	They will listen to their favourite players .	pres_fut	17
In fact , you travel in some comfort .	In fact , you will travel in some comfort .	pres_fut	20
At the moment we do not know how we manage without him .	At the moment we do not know how we will manage without him .	pres_fut	21
I give you one random example .	I will give you one random example .	pres_fut	22
" We give you a warning , " Hanny replied .	" We will give you a warning , " Hanny replied .	pres_fut	23
I leave that one to his conscience .	I will leave that one to his conscience .	pres_fut	24
I trust that he does not admire Hitler .	I will trust that he does not admire Hitler .	pres_fut	25
You need at least 6 circles .	You will need at least 6 circles .	pres_fut	26
" I assure you one thing , " he said .	" I will assure you one thing , " he said .	pres_fut	27
I tell you that it is not isolated to the South .	I will tell you that it is not isolated to the South .	pres_fut	28
" " That is exactly what you see .	" " That is exactly what you will see .	pres_fut	29
You get more sales and higher bids if you accept credit cards .	You will get more sales and higher bids if you accept credit cards .	pres_fut	30
But they make a joint visit to a local school .	But they will make a joint visit to a local school .	pres_fut	31
They testify against Hager , prosecutors said .	They will testify against Hager , prosecutors said .	pres_fut	33
That night they sleep in their cars .	That night they will sleep in their cars .	pres_fut	34
" We resist this nonconstitutional action , " he said .	" We will resist this nonconstitutional action , " he said .	pres_fut	36
We see what the future holds .	We will see what the future holds .	pres_fut	37
If we stay healthy and we pitch well , we win .	If we stay healthy and we pitch well , we will win .	pres_fut	38
Don 't worry , I look after you .	Don 't worry , I will look after you .	pres_fut	40
I help .	I will help .	pres_fut	41
If you build it they come .	If you build it they will come .	pres_fut	42
They prevent headaches .	They will prevent headaches .	pres_fut	43
Whether or not that is the case , we find out .	Whether or not that is the case , we will find out .	pres_fut	44
So we see what can happen in two weeks .	So we will see what can happen in two weeks .	pres_fut	45
I appeal it .	I will appeal it .	pres_fut	46
I stand up for British values .	I will stand up for British values .	pres_fut	47
We bury you .	We will bury you .	pres_fut	48
Instead , they revel in its extraordinary silence .	Instead , they will revel in its extraordinary silence .	pres_fut	49
We do it together with the Jordanians .	We will do it together with the Jordanians .	pres_fut	50
I analyze and I will make a decision .	I will analyze and I will make a decision .	pres_fut	51
I look after our baby boy .	I will look after our baby boy .	pres_fut	55
Though they offer premium cabins for business customers .	Though they will offer premium cabins for business customers .	pres_fut	56
" " I hope they make it .	" " I hope they will make it .	pres_fut	57
We keep you informed us our progress .	We will keep you informed us our progress .	pres_fut	60
But you find some lovely new-home communities near your new headquarters .	But you will find some lovely new-home communities near your new headquarters .	pres_fut	61
Senator Obama , we begin with you .	Senator Obama , we will begin with you .	pres_fut	62
Islamist leaders react by saying they tackle foreign forces as invaders .	Islamist leaders react by saying they will tackle foreign forces as invaders .	pres_fut	63
Sometimes I go to a friend 's house .	Sometimes I will go to a friend 's house .	pres_fut	64
They carry on building .	They will carry on building .	pres_fut	65
That means I make some mistakes .	That means I will make some mistakes .	pres_fut	67
" I think we bounce back , " she said .	" I think we will bounce back , " she said .	pres_fut	68
Maulvi Sahib : OK I come .	Maulvi Sahib : OK I will come .	pres_fut	70
I ruin your night .	I will ruin your night .	pres_fut	75
We gain mastery .	We will gain mastery .	pres_fut	79
For reasons we explore in our next rule .	For reasons we will explore in our next rule .	pres_fut	81
We need to come up with radical concepts .	We will need to come up with radical concepts .	pres_fut	82
Eventually we shut down .	Eventually we will shut down .	pres_fut	85
We hope you join us .	We hope you will join us .	pres_fut	88
Rather we conduct peaceful protests .	Rather we will conduct peaceful protests .	pres_fut	89
His lawyers have said they appeal .	His lawyers have said they will appeal .	pres_fut	90
I give this jersey to him .	I will give this jersey to him .	pres_fut	94
We deliver to its people peace and dignity .	We will deliver to its people peace and dignity .	pres_fut	95
We put the politicians to the test .	We will put the politicians to the test .	pres_fut	96
We take it out of the script .	We will take it out of the script .	pres_fut	98
" I say one thing , " King said .	" I will say one thing , " King said .	pres_fut	100
They strike at the bone .	They will strike at the bone .	pres_fut	101
We review the World Cup correctly and properly and move forward .	We will review the World Cup correctly and properly and move forward .	pres_fut	102
I stay right in the middle of this effort .	I will stay right in the middle of this effort .	pres_fut	104
They say anything to make the pain stop .	They will say anything to make the pain stop .	pres_fut	105
You need Windows Media Player .	You will need Windows Media Player .	pres_fut	106
Well , I try to live up to that definition .	Well , I will try to live up to that definition .	pres_fut	107
But I give you reason to trust me .	But I will give you reason to trust me .	pres_fut	108
After that we see what happens .	After that we will see what happens .	pres_fut	110
We confront this danger before it is too late .	We will confront this danger before it is too late .	pres_fut	112
Prosecutors have said they seek the death penalty .	Prosecutors have said they will seek the death penalty .	pres_fut	113
They play Potions Professor Horace Slughorn and Narcissa Malfoy respectively .	They will play Potions Professor Horace Slughorn and Narcissa Malfoy respectively .	pres_fut	115
Prosecutors said they seek the death penalty if Montgomery is convicted .	Prosecutors said they will seek the death penalty if Montgomery is convicted .	pres_fut	116
I do not think we maintain the status quo .	I do not think we will maintain the status quo .	pres_fut	117
They swamp the locations of big city airports and major interstate highways .	They will swamp the locations of big city airports and major interstate highways .	pres_fut	118
I show you what I am capable of .	I will show you what I am capable of .	pres_fut	119
We continue preserving the tapes in compliance with the court 's order .	We will continue preserving the tapes in compliance with the court 's order .	pres_fut	121
And we continue to make that -- to make that point .	And we will continue to make that -- to make that point .	pres_fut	122
You find me in the bathroom .	You will find me in the bathroom .	pres_fut	123
When the inquiry is concluded , we take appropriate action .	When the inquiry is concluded , we will take appropriate action .	pres_fut	126
That is the way you get your rest .	That is the way you will get your rest .	pres_fut	128
If you persevere , you find your way .	If you persevere , you will find your way .	pres_fut	129
They highlight Corporate initiatives and Aeronautics business area activities .	They will highlight Corporate initiatives and Aeronautics business area activities .	pres_fut	131
We adapt to that .	We will adapt to that .	pres_fut	132
we leave that aspect there .	we will leave that aspect there .	pres_fut	134
We help them to provide for their people because we are Americans .	We will help them to provide for their people because we are Americans .	pres_fut	136
But I allow my injuries to heal first .	But I will allow my injuries to heal first .	pres_fut	138
I say that Juan has a multiyear deal with us .	I will say that Juan has a multiyear deal with us .	pres_fut	140
We look .	We will look .	pres_fut	141
Not that you lack entertainment whilst you wait .	Not that you will lack entertainment whilst you wait .	pres_fut	142
They entertain Manchester United , before travelling to Old Trafford .	They will entertain Manchester United , before travelling to Old Trafford .	pres_fut	144
You can be sure we listen to it .	You can be sure we will listen to it .	pres_fut	145
We end this war .	We will end this war .	pres_fut	146
You need 6 or more nice rounds ( see Step 2 ) .	You will need 6 or more nice rounds ( see Step 2 ) .	pres_fut	147
You find the moon in tow .	You will find the moon in tow .	pres_fut	149
" " We continue to do Warhol .	" " We will continue to do Warhol .	pres_fut	150
We let you know as soon as we can .	We will let you know as soon as we can .	pres_fut	151
Mehsud : I wait for you .	Mehsud : I will wait for you .	pres_fut	154
We maintain our financial flexibility while prudently executing our plan .	We will maintain our financial flexibility while prudently executing our plan .	pres_fut	155
" " I think we find out .	" " I think we will find out .	pres_fut	156
We benefit tremendously from his knowledge and expertise .	We will benefit tremendously from his knowledge and expertise .	pres_fut	157
" But we pick ' em back up .	" But we will pick ' em back up .	pres_fut	160
" We keep people posted , " he said .	" We will keep people posted , " he said .	pres_fut	161
We know more after Monday .	We will know more after Monday .	pres_fut	163
I spend as little as possible on food .	I will spend as little as possible on food .	pres_fut	164
They arrive in two days .	They will arrive in two days .	pres_fut	165
But it is up to the I.O.C. to decide where they go .	But it is up to the I.O.C. to decide where they will go .	pres_fut	166
" " I let you in on a secret .	" " I will let you in on a secret .	pres_fut	168
We show you mere mortals .	We will show you mere mortals .	pres_fut	169
You discover fast that asset-protection schemes rarely work .	You will discover fast that asset-protection schemes rarely work .	pres_fut	170
I am confident that we prevail .	I am confident that we will prevail .	pres_fut	172
They said they ask a prosecutor to consider the case .	They said they will ask a prosecutor to consider the case .	pres_fut	173
They go as far as they can .	They will go as far as they can .	pres_fut	176
I believe that we see a democratic state .	I believe that we will see a democratic state .	pres_fut	177
Whatever keeps the neighborhood happy , we do .	Whatever keeps the neighborhood happy , we will do .	pres_fut	179
They look to use the ball straightaway .	They will look to use the ball straightaway .	pres_fut	180
We reverse that decline .	We will reverse that decline .	pres_fut	184
I need my best performance to beat Joe .	I will need my best performance to beat Joe .	pres_fut	188
I see a house built on it .	I will see a house built on it .	pres_fut	191
They help correct the credit markets .	They will help correct the credit markets .	pres_fut	194
We keep crying and praying together .	We will keep crying and praying together .	pres_fut	195
They move under their supervision .	They will move under their supervision .	pres_fut	196
If not we review the incident .	If not we will review the incident .	pres_fut	197
But we see .	But we will see .	pres_fut	198
They dispense euros and dollars as well as pounds .	They will dispense euros and dollars as well as pounds .	pres_fut	199
At the same time we launch a new FHA initiative called FHASecure .	At the same time we will launch a new FHA initiative called FHASecure .	pres_fut	200
But we use that to motivate the players .	But we will use that to motivate the players .	pres_fut	201
They said this week they distribute brand-name substitutes .	They said this week they will distribute brand-name substitutes .	pres_fut	203
I can promise our fans we do that .	I can promise our fans we will do that .	pres_fut	204
When we see the lawsuit , we deal with it .	When we see the lawsuit , we will deal with it .	pres_fut	205
I oppose this nomination .	I will oppose this nomination .	pres_fut	206
I was a Nazi and I stay a Nazi .	I was a Nazi and I will stay a Nazi .	pres_fut	211
But at the same time , I take it .	But at the same time , I will take it .	pres_fut	212
They move to Lucas Oil Stadium next season .	They will move to Lucas Oil Stadium next season .	pres_fut	213
You die here .	You will die here .	pres_fut	214
I stop .	I will stop .	pres_fut	216
God willing they die in their jealousy .	God willing they will die in their jealousy .	pres_fut	217
They receive second prizes of $ 250,000 each .	They will receive second prizes of $ 250,000 each .	pres_fut	218
We need leaders and warriors to step up to the plate .	We will need leaders and warriors to step up to the plate .	pres_fut	219
I cut you or I will stab you ' .	I will cut you or I will stab you ' .	pres_fut	221
" If it comes , we welcome it , " she said .	" If it comes , we will welcome it , " she said .	pres_fut	222
They start excavation on that site shortly .	They will start excavation on that site shortly .	pres_fut	223
So , we go after it next week .	So , we will go after it next week .	pres_fut	227
This is an issue we address with FDA .	This is an issue we will address with FDA .	pres_fut	231
But we see you tomorrow for more CNN Student News .	But we will see you tomorrow for more CNN Student News .	pres_fut	232
" I think we re-sign him , " Steinbrenner told the paper .	" I think we will re-sign him , " Steinbrenner told the paper .	pres_fut	233
We force European consumers to pay higher prices .	We will force European consumers to pay higher prices .	pres_fut	234
I miss him .	I will miss him .	pres_fut	235
They try to make this week no different .	They will try to make this week no different .	pres_fut	236
Or we report you .	Or we will report you .	pres_fut	237
As president of the United States , I do that .	As president of the United States , I will do that .	pres_fut	238
I am sure they manage it all .	I am sure they will manage it all .	pres_fut	240
In a few years , maybe we go ahead .	In a few years , maybe we will go ahead .	pres_fut	241
They extradite her here .	They will extradite her here .	pres_fut	242
But we look forward to seeing you again tomorrow .	But we will look forward to seeing you again tomorrow .	pres_fut	243
We make sure that you are safe .	We will make sure that you are safe .	pres_fut	244
" " We keep supporting them in the future .	" " We will keep supporting them in the future .	pres_fut	246
If it is 2-nothing , we take that .	If it is 2-nothing , we will take that .	pres_fut	247
I wait and see .	I will wait and see .	pres_fut	249
If we just play , we win the game .	If we just play , we will win the game .	pres_fut	250
" I practice , " Chakvetadze said .	" I will practice , " Chakvetadze said .	pres_fut	251
But I think I play well in the next match .	But I think I will play well in the next match .	pres_fut	252
Prosecutors have said they seek the death penalty if Montgomery is convicted .	Prosecutors have said they will seek the death penalty if Montgomery is convicted .	pres_fut	253
Jump and you come back down .	Jump and you will come back down .	pres_fut	254
No , they think : Andy Pettitte .	No , they will think : Andy Pettitte .	pres_fut	255
" Then we move it inside , thankfully , " Brantley said .	" Then we will move it inside , thankfully , " Brantley said .	pres_fut	257
" We continue to pursue him , " General Rifi said .	" We will continue to pursue him , " General Rifi said .	pres_fut	258
But I continue to work hard with the players .	But I will continue to work hard with the players .	pres_fut	259
But it does not look like they change their minds .	But it does not look like they will change their minds .	pres_fut	260
I am determined that we live up to that .	I am determined that we will live up to that .	pres_fut	261
We miss his wisdom , wit and contributions .	We will miss his wisdom , wit and contributions .	pres_fut	262
But we see how it goes on Sunday .	But we will see how it goes on Sunday .	pres_fut	263
Eventually , they raise your real estate tax .	Eventually , they will raise your real estate tax .	pres_fut	264
So we go with this .	So we will go with this .	pres_fut	265
And I do everything I can to prevent them from breaking .	And I will do everything I can to prevent them from breaking .	pres_fut	266
You need a steamer big enough to cook the 6 parcels together .	You will need a steamer big enough to cook the 6 parcels together .	pres_fut	267
But we try to make it different this year .	But we will try to make it different this year .	pres_fut	268
They extend 240 feet from tip to tip when outstretched .	They will extend 240 feet from tip to tip when outstretched .	pres_fut	269
We step in whenever false claims are being made .	We will step in whenever false claims are being made .	pres_fut	270
Maybe we find out in 2008 .	Maybe we will find out in 2008 .	pres_fut	271
I am interested in knowing how far they go .	I am interested in knowing how far they will go .	pres_fut	272
We continue to enhance our global footprint .	We will continue to enhance our global footprint .	pres_fut	274
They begin their two-year terms on Jan. 1 , 2008 .	They will begin their two-year terms on Jan. 1 , 2008 .	pres_fut	275
If they want us to stay we stay .	If they want us to stay we will stay .	pres_fut	276
They investigate the matter fully , I guarantee you .	They will investigate the matter fully , I guarantee you .	pres_fut	277
We strengthen our ties with our friends .	We will strengthen our ties with our friends .	pres_fut	279
They appear before South East Northumberland Magistrates ' Court on Friday morning .	They will appear before South East Northumberland Magistrates ' Court on Friday morning .	pres_fut	281
Several states have said they appeal the decision .	Several states have said they will appeal the decision .	pres_fut	282
We continue to monitor the situation .	We will continue to monitor the situation .	pres_fut	283
And , yes , you feel the tower sway .	And , yes , you will feel the tower sway .	pres_fut	284
If they want us to leave we do so .	If they want us to leave we will do so .	pres_fut	287
" We take our revenge , " the mourners chanted .	" We will take our revenge , " the mourners chanted .	pres_fut	288
I face up to them .	I will face up to them .	pres_fut	289
Some secrets I take to my grave .	Some secrets I will take to my grave .	pres_fut	292
We see .	We will see .	pres_fut	294
I give you more details when I come .	I will give you more details when I come .	pres_fut	295
We set a long-term goal for reducing global greenhouse gas emissions .	We will set a long-term goal for reducing global greenhouse gas emissions .	pres_fut	297
Yes , we recognise marriage in the tax system .	Yes , we will recognise marriage in the tax system .	pres_fut	298
I try to as well .	I will try to as well .	pres_fut	300
I say it one more time .	I will say it one more time .	pres_fut	301
But you turn 70 with your head held high .	But you will turn 70 with your head held high .	pres_fut	302
The expectation is that along the way they get an education .	The expectation is that along the way they will get an education .	pres_fut	303
We march wearing black arm bands because we are mourning .	We will march wearing black arm bands because we are mourning .	pres_fut	304
You see how the youth will come out .	You will see how the youth will come out .	pres_fut	306
You say the wrong thing .	You will say the wrong thing .	pres_fut	307
But they struggle to change entrenched social customs .	But they will struggle to change entrenched social customs .	pres_fut	308
I can almost guarantee that you win them over .	I can almost guarantee that you will win them over .	pres_fut	309
So , we see how sore he is .	So , we will see how sore he is .	pres_fut	310
They join NXP 's Mobile and Personal Business unit .	They will join NXP 's Mobile and Personal Business unit .	pres_fut	312
We try our best like always on the field .	We will try our best like always on the field .	pres_fut	313
Anyway , we see .	Anyway , we will see .	pres_fut	314
We look to further expand our joint venture activities .	We will look to further expand our joint venture activities .	pres_fut	315
" We live with it , " Holmgren said .	" We will live with it , " Holmgren said .	pres_fut	316
We remain a major force in Auburn Hills .	We will remain a major force in Auburn Hills .	pres_fut	317
We choose our favourites and publish a selection online .	We will choose our favourites and publish a selection online .	pres_fut	319
And we add our first hybrid to the fleet next year .	And we will add our first hybrid to the fleet next year .	pres_fut	320
We get the person who committed this crime .	We will get the person who committed this crime .	pres_fut	322
We take it very seriously , and we continue to do that .	We take it very seriously , and we will continue to do that .	pres_fut	323
Prosecutors have said they pursue the death penalty .	Prosecutors have said they will pursue the death penalty .	pres_fut	325
Next Monday we visit Richmond .	Next Monday we will visit Richmond .	pres_fut	326
I take the Bollywood formula and apply it there .	I will take the Bollywood formula and apply it there .	pres_fut	327
We continue to contribute to RAP by providing our qooxdoo JavaScript framework .	We will continue to contribute to RAP by providing our qooxdoo JavaScript framework .	pres_fut	328
There is no sign they field a candidate of their own .	There is no sign they will field a candidate of their own .	pres_fut	329
I promise that we take no risks with stability .	I promise that we will take no risks with stability .	pres_fut	331
We take this all the way to a public inquiry .	We will take this all the way to a public inquiry .	pres_fut	334
I set up my government very soon .	I will set up my government very soon .	pres_fut	335
I say I am not running for vice president .	I will say I am not running for vice president .	pres_fut	336
This plan shows how we do it .	This plan shows how we will do it .	pres_fut	337
We continue to focus on disciplined underwriting and manage expenses accordingly .	We will continue to focus on disciplined underwriting and manage expenses accordingly .	pres_fut	339
Or they pass a note on paper .	Or they will pass a note on paper .	pres_fut	340
Q : OK , we change the subject .	Q : OK , we will change the subject .	pres_fut	341
We stay here until we feel it is safe .	We will stay here until we feel it is safe .	pres_fut	342
I do that to the best of my ability .	I will do that to the best of my ability .	pres_fut	344
When you learn to cook then you die .	When you learn to cook then you will die .	pres_fut	346
They discuss economic , political and terrorism-related issues .	They will discuss economic , political and terrorism-related issues .	pres_fut	347
And we maintain a diverse , integrated business portfolio .	And we will maintain a diverse , integrated business portfolio .	pres_fut	348
We assess how he performs in training .	We will assess how he performs in training .	pres_fut	351
We are hopeful that we see some clarification .	We are hopeful that we will see some clarification .	pres_fut	352
And we continue to -- dialoguing with the Turks .	And we will continue to -- dialoguing with the Turks .	pres_fut	354
They feel like they are being torn apart .	They will feel like they are being torn apart .	pres_fut	355
I hope you get information from the curator .	I hope you will get information from the curator .	pres_fut	357
They depart from Faro Airport .	They will depart from Faro Airport .	pres_fut	359
We use that to ignite us .	We will use that to ignite us .	pres_fut	360
And under a Conservative government we control it .	And under a Conservative government we will control it .	pres_fut	361
For now , we wait .	For now , we will wait .	pres_fut	362
I use what I have until it is gone .	I will use what I have until it is gone .	pres_fut	363
So we keep you posted .	So we will keep you posted .	pres_fut	367
They kick off the night session at Ashe .	They will kick off the night session at Ashe .	pres_fut	368
" " I continue to say that .	" " I will continue to say that .	pres_fut	369
We do nothing to put at risk the Union .	We will do nothing to put at risk the Union .	pres_fut	371
I keep on going until I reach my goal .	I will keep on going until I reach my goal .	pres_fut	374
" You say , " Apollinarianism !	" You will say , " Apollinarianism !	pres_fut	375
I work with my Albanian colleagues , but our friendship ends there .	I will work with my Albanian colleagues , but our friendship ends there .	pres_fut	376
They provide for reduced infections and higher cleaning standards .	They will provide for reduced infections and higher cleaning standards .	pres_fut	379
Of course we respond to messages .	Of course we will respond to messages .	pres_fut	380
Please fill in the following information and we email this link .	Please fill in the following information and we will email this link .	pres_fut	381
We do our utmost bring the offender to justice .	We will do our utmost bring the offender to justice .	pres_fut	382
She hopes they marry , she said .	She hopes they will marry , she said .	pres_fut	385
We miss him and wish him well in his retirement .	We will miss him and wish him well in his retirement .	pres_fut	386
We finish the job of building permanent shelters by December 2008 .	We will finish the job of building permanent shelters by December 2008 .	pres_fut	389
As for me , I buy second hand items .	As for me , I will buy second hand items .	pres_fut	390
You understand that you are not acting correctly .	You will understand that you are not acting correctly .	pres_fut	391
This afternoon I lay out my initial thoughts .	This afternoon I will lay out my initial thoughts .	pres_fut	392
" But I look at them very carefully , " he said .	" But I will look at them very carefully , " he said .	pres_fut	393
We wait for his return .	We will wait for his return .	pres_fut	396
If you get sick seriously , you die .	If you get sick seriously , you will die .	pres_fut	397
But I deliver the punchline when I am 150 years old .	But I will deliver the punchline when I am 150 years old .	pres_fut	398
But we see you tomorrow as we wrap up the week .	But we will see you tomorrow as we wrap up the week .	pres_fut	401
That is step one and we take it from there .	That is step one and we will take it from there .	pres_fut	403
Q And we leave it right there .	Q And we will leave it right there .	pres_fut	404
We take threats seriously .	We will take threats seriously .	pres_fut	406
From next April , they pay only 18 per cent .	From next April , they will pay only 18 per cent .	pres_fut	407
We bring the country out of this crisis .	We will bring the country out of this crisis .	pres_fut	408
From now on , they become city dwellers .	From now on , they will become city dwellers .	pres_fut	409
They ask that each nation send its highest-ranking appropriate official to Annapolis .	They will ask that each nation send its highest-ranking appropriate official to Annapolis .	pres_fut	413
I sum up what I know so far .	I will sum up what I know so far .	pres_fut	414
They present a second workshop at Juilliard in January 2009 .	They will present a second workshop at Juilliard in January 2009 .	pres_fut	415
And we play those guys .	And we will play those guys .	pres_fut	417
There are so many aspects that we focus on .	There are so many aspects that we will focus on .	pres_fut	418
They make ballparks desolate sites .	They will make ballparks desolate sites .	pres_fut	419
You get 12 years for this .	You will get 12 years for this .	pres_fut	420
Like floaters , they cast a shadow .	Like floaters , they will cast a shadow .	pres_fut	421
And that is a big part of what they miss .	And that is a big part of what they will miss .	pres_fut	422
But we try to find out .	But we will try to find out .	pres_fut	423
They increase by 310,000 by the end of the decade .	They will increase by 310,000 by the end of the decade .	pres_fut	424
That is what Democratic leaders are signaling they do .	That is what Democratic leaders are signaling they will do .	pres_fut	425
I discuss this issue with Sumgayit city leadership .	I will discuss this issue with Sumgayit city leadership .	pres_fut	426
I update as the day progresses .	I will update as the day progresses .	pres_fut	427
We accept only armed soldiers as representatives of armed states .	We will accept only armed soldiers as representatives of armed states .	pres_fut	428
I mail the letters .	I will mail the letters .	pres_fut	429
So I do some exercise for here .	So I will do some exercise for here .	pres_fut	430
We miss him greatly .	We will miss him greatly .	pres_fut	433
I think about it in the next couple of days .	I will think about it in the next couple of days .	pres_fut	435
They discuss potential cooperation between similar sectors in both countries .	They will discuss potential cooperation between similar sectors in both countries .	pres_fut	436
We see this year 's Benfica tomorrow .	We will see this year 's Benfica tomorrow .	pres_fut	438
You need Ordnance Survey Map 41 .	You will need Ordnance Survey Map 41 .	pres_fut	440
Together , we seize the opportunities and challenges that lie ahead .	Together , we will seize the opportunities and challenges that lie ahead .	pres_fut	441
We continue to react against Israeli crimes .	We will continue to react against Israeli crimes .	pres_fut	442
We see it through .	We will see it through .	pres_fut	444
I expect that everyone can just respect that .	I will expect that everyone can just respect that .	pres_fut	445
" " I get the first one !	" " I will get the first one !	pres_fut	448
They need to accommodate this growing involvement of the private sector .	They will need to accommodate this growing involvement of the private sector .	pres_fut	450
you accomplish your goal .	you will accomplish your goal .	pres_fut	452
We live up to a higher standard .	We will live up to a higher standard .	pres_fut	453
I comply .	I will comply .	pres_fut	454
Divorce lawyers believe they settle .	Divorce lawyers believe they will settle .	pres_fut	455
We make an assessment then .	We will make an assessment then .	pres_fut	456
I discuss the changes our strategy has brought to Iraq .	I will discuss the changes our strategy has brought to Iraq .	pres_fut	457
We deal with it at home , though .	We will deal with it at home , though .	pres_fut	459
And , as you see , every little bit matters .	And , as you will see , every little bit matters .	pres_fut	460
I share that excitement .	I will share that excitement .	pres_fut	461
And then I take oath .	And then I will take oath .	pres_fut	463
And that is exactly what we continue to do .	And that is exactly what we will continue to do .	pres_fut	465
They appear at Kingston-Upon-Thames Magistrates ' Court on 15 November .	They will appear at Kingston-Upon-Thames Magistrates ' Court on 15 November .	pres_fut	466
And so we take the action necessary to keep that from happening .	And so we will take the action necessary to keep that from happening .	pres_fut	469
If all monks agree , we carry on .	If all monks agree , we will carry on .	pres_fut	470
So we see .	So we will see .	pres_fut	472
I cooperate fully with the person appointed .	I will cooperate fully with the person appointed .	pres_fut	475
But they overcome fear to eat .	But they will overcome fear to eat .	pres_fut	477
We follow the evidence .	We will follow the evidence .	pres_fut	478
We await their report and consider it carefully .	We will await their report and consider it carefully .	pres_fut	479
Hopefully they agree to that .	Hopefully they will agree to that .	pres_fut	480
Yes , and I go there .	Yes , and I will go there .	pres_fut	482
I have faith that I receive a fair hearing .	I have faith that I will receive a fair hearing .	pres_fut	485
We continue to add to our world class merchandise team .	We will continue to add to our world class merchandise team .	pres_fut	486
We are confident they clear their names shortly .	We are confident they will clear their names shortly .	pres_fut	487
They play the Patriots in Foxborough , Mass .	They will play the Patriots in Foxborough , Mass .	pres_fut	488
We take measurements at the end of every month .	We will take measurements at the end of every month .	pres_fut	490
But we try to give them a tough time .	But we will try to give them a tough time .	pres_fut	495
They worry about October if they even get there .	They will worry about October if they even get there .	pres_fut	496
That is where you find real music television these days .	That is where you will find real music television these days .	pres_fut	497
They get nowhere trying to challenge Gordon Brown 's authenticity .	They will get nowhere trying to challenge Gordon Brown 's authenticity .	pres_fut	498
On this course you play every club in your bag .	On this course you will play every club in your bag .	pres_fut	499
We get back on track as we always do .	We will get back on track as we always do .	pres_fut	500
Then , they come and threaten us to obtain another concession .	Then , they will come and threaten us to obtain another concession .	pres_fut	501
They remain at the trust .	They will remain at the trust .	pres_fut	502
They have said they return to Portugal for questioning if needed .	They have said they will return to Portugal for questioning if needed .	pres_fut	503
They come up against opposition from some quarters .	They will come up against opposition from some quarters .	pres_fut	507
In the future we see .	In the future we will see .	pres_fut	508
If everything goes well , I play .	If everything goes well , I will play .	pres_fut	509
I start celebrating when I reach 43 days .	I will start celebrating when I reach 43 days .	pres_fut	510
And they know I veto it .	And they know I will veto it .	pres_fut	511
" They need five years , " she said .	" They will need five years , " she said .	pres_fut	512
How they mesh remains unclear .	How they will mesh remains unclear .	pres_fut	514
They replace comprehensive performance assessments , which focus solely on individual councils .	They will replace comprehensive performance assessments , which focus solely on individual councils .	pres_fut	515
We see now how he uses it .	We will see now how he uses it .	pres_fut	517
" We clean it up , " Wilson said .	" We will clean it up , " Wilson said .	pres_fut	518
And many students say they join him .	And many students say they will join him .	pres_fut	520
I am convinced we win though .	I am convinced we will win though .	pres_fut	522
I really hope they reconsider .	I really hope they will reconsider .	pres_fut	523
I consult my stable master .	I will consult my stable master .	pres_fut	524
We see soon how Musharraf acts .	We will see soon how Musharraf acts .	pres_fut	525
" We change our procedure on that , " Belichick said .	" We will change our procedure on that , " Belichick said .	pres_fut	526
We give health coverage to everyone .	We will give health coverage to everyone .	pres_fut	528
" We change our procedure on that , " the coach said .	" We will change our procedure on that , " the coach said .	pres_fut	529
Yes , we do video .	Yes , we will do video .	pres_fut	531
They reappear at the court in the new year .	They will reappear at the court in the new year .	pres_fut	532
Then I remember the times we had together .	Then I will remember the times we had together .	pres_fut	533
What you start , we do .	What you start , we will do .	pres_fut	534
We remain hopeful we get her back safely .	We remain hopeful we will get her back safely .	pres_fut	535
We deliver .	We will deliver .	pres_fut	536
We are confident that we meet our 2007 full year performance guidance .	We are confident that we will meet our 2007 full year performance guidance .	pres_fut	538
They meet again Sunday in Denver .	They will meet again Sunday in Denver .	pres_fut	540
We consult all the political parties to take any decision about it .	We will consult all the political parties to take any decision about it .	pres_fut	541
Otherwise they become mere offshoots of the state .	Otherwise they will become mere offshoots of the state .	pres_fut	544
We go forward and join consensus .	We will go forward and join consensus .	pres_fut	545
We learn from this .	We will learn from this .	pres_fut	546
We resist it .	We will resist it .	pres_fut	547
But I come back next year stronger , for sure .	But I will come back next year stronger , for sure .	pres_fut	548
We continue to provide Inventec with outstanding service in years to come .	We will continue to provide Inventec with outstanding service in years to come .	pres_fut	549
If it continues , we lose them in 10-12 years .	If it continues , we will lose them in 10-12 years .	pres_fut	551
I hope that I see that day .	I hope that I will see that day .	pres_fut	553
They call me when their families are having problems .	They will call me when their families are having problems .	pres_fut	554
I appeal this .	I will appeal this .	pres_fut	555
I stand up for a strong Britain .	I will stand up for a strong Britain .	pres_fut	556
We test right before or right after Thanksgiving .	We will test right before or right after Thanksgiving .	pres_fut	557
We try and find allies for this cause .	We will try and find allies for this cause .	pres_fut	558
As we move forward , we continue to welcome new ideas .	As we move forward , we will continue to welcome new ideas .	pres_fut	562
I miss him and the dancing more than I had ever imagined .	I will miss him and the dancing more than I had ever imagined .	pres_fut	563
We focus the entire organisation on the return on capital .	We will focus the entire organisation on the return on capital .	pres_fut	564
It is going to take time and we monitor the situation .	It is going to take time and we will monitor the situation .	pres_fut	566
And you pay dearly for it .	And you will pay dearly for it .	pres_fut	567
I receive my degree in ancient philosophy .	I will receive my degree in ancient philosophy .	pres_fut	568
Instead they stress the special place books have in society .	Instead they will stress the special place books have in society .	pres_fut	571
I spend about the same as last year .	I will spend about the same as last year .	pres_fut	572
We try to do it against Lithuania .	We will try to do it against Lithuania .	pres_fut	574
" Now we bring revolution , " Rehmatullah said .	" Now we will bring revolution , " Rehmatullah said .	pres_fut	575
So , we see .	So , we will see .	pres_fut	576
They share the $ 1.5 million prize .	They will share the $ 1.5 million prize .	pres_fut	577
It is something that we persist with .	It is something that we will persist with .	pres_fut	579
" " And they get listened to .	" " And they will get listened to .	pres_fut	580
They go before Fife Council later in the year .	They will go before Fife Council later in the year .	pres_fut	581
You need a Freeview aerial , satellite , cable or broadband .	You will need a Freeview aerial , satellite , cable or broadband .	pres_fut	583
We take the revenge on the rulers .	We will take the revenge on the rulers .	pres_fut	585
Whether they take that look remains to be seen .	Whether they will take that look remains to be seen .	pres_fut	586
But we back ourselves on Saturday .	But we will back ourselves on Saturday .	pres_fut	587
I work with Nawaz Sharif .	I will work with Nawaz Sharif .	pres_fut	589
They run out of groundwater if the current rate continues .	They will run out of groundwater if the current rate continues .	pres_fut	590
We consider aid once we see progress on the abductions issue .	We will consider aid once we see progress on the abductions issue .	pres_fut	591
They fear neither team in Saturday 's final .	They will fear neither team in Saturday 's final .	pres_fut	593
" I think they come back , " he said softly .	" I think they will come back , " he said softly .	pres_fut	594
They appear on billboards as young people play their favourite titles .	They will appear on billboards as young people play their favourite titles .	pres_fut	595
Perhaps we catch him next time .	Perhaps we will catch him next time .	pres_fut	597
We drive down Total Cost of Ownership while Supercharging System performance .	We will drive down Total Cost of Ownership while Supercharging System performance .	pres_fut	598
When you stand for your liberty , we stand with you .	When you stand for your liberty , we will stand with you .	pres_fut	600
Otherwise we fire .	Otherwise we will fire .	pres_fut	602
I find her before that period is up .	I will find her before that period is up .	pres_fut	603
Yes , we do games .	Yes , we will do games .	pres_fut	604
" We try Phil Spector again , " the spokeswoman said .	" We will try Phil Spector again , " the spokeswoman said .	pres_fut	607
They light a lantern in the Prayer Hall .	They will light a lantern in the Prayer Hall .	pres_fut	608
But we see you right back here tomorrow .	But we will see you right back here tomorrow .	pres_fut	609
In 2008 we see what that means .	In 2008 we will see what that means .	pres_fut	612
We shop for a better offer .	We will shop for a better offer .	pres_fut	613
They adhere to an ideological position and then change it .	They will adhere to an ideological position and then change it .	pres_fut	614
You need to consider various possibilities of driver error .	You will need to consider various possibilities of driver error .	pres_fut	616
" I say the stuff is pretty sensational , " he said .	" I will say the stuff is pretty sensational , " he said .	pres_fut	617
" I believe we continue to grow , " Mr. Paulson said .	" I believe we will continue to grow , " Mr. Paulson said .	pres_fut	620
They swamp big city airports and major interstate highways .	They will swamp big city airports and major interstate highways .	pres_fut	621
You die .	You will die .	pres_fut	622
You need to replace the lipstick .	You will need to replace the lipstick .	pres_fut	624
You do the wrong thing .	You will do the wrong thing .	pres_fut	625
So we reform stroke services and save lives .	So we will reform stroke services and save lives .	pres_fut	626
If he does not quit , we kill him .	If he does not quit , we will kill him .	pres_fut	628
We encounter many other things , of course .	We will encounter many other things , of course .	pres_fut	629
" We need to monitor inflation developments carefully , " he said .	" We will need to monitor inflation developments carefully , " he said .	pres_fut	630
And we ignore those that cannot .	And we will ignore those that cannot .	pres_fut	631
I win big .	I will win big .	pres_fut	632
We need more qualified people running the Fed in the future .	We will need more qualified people running the Fed in the future .	pres_fut	633
The answer is , we know soon .	The answer is , we will know soon .	pres_fut	634
They fly dogs across the United States .	They will fly dogs across the United States .	pres_fut	635
He is still day-to-day , and we see what happens .	He is still day-to-day , and we will see what happens .	pres_fut	637
We get some guys back in December .	We will get some guys back in December .	pres_fut	638
They bring to 18 the total number of satellites mapping Russian territory .	They will bring to 18 the total number of satellites mapping Russian territory .	pres_fut	639
" " We continue to take all actions to maximise shareholder value .	" " We will continue to take all actions to maximise shareholder value .	pres_fut	641
And we introduce a major abstinence-based drugs rehabilitation program .	And we will introduce a major abstinence-based drugs rehabilitation program .	pres_fut	642
We do everything to challenge .	We will do everything to challenge .	pres_fut	644
Yes , you learn a lot .	Yes , you will learn a lot .	pres_fut	646
We target Asian markets specifically such as China and India .	We will target Asian markets specifically such as China and India .	pres_fut	647
And we continue working to that end .	And we will continue working to that end .	pres_fut	648
" I stay here until things are calm , " Jean said .	" I will stay here until things are calm , " Jean said .	pres_fut	649
We fight , Britain will win .	We will fight , Britain will win .	pres_fut	652
" " And they know I veto it .	" " And they know I will veto it .	pres_fut	653
Next time I keep watch .	Next time I will keep watch .	pres_fut	655
The rest of you stay .	The rest of you will stay .	pres_fut	656
They work to increase the amount later in the semester .	They will work to increase the amount later in the semester .	pres_fut	658
You get a good belly laugh at the end of the season .	You will get a good belly laugh at the end of the season .	pres_fut	659
We fight .	We will fight .	pres_fut	660
You get more moments of joy ' .	You will get more moments of joy ' .	pres_fut	663
We wait and see what the consultation process says .	We will wait and see what the consultation process says .	pres_fut	664
I continue to be a revolutionary .	I will continue to be a revolutionary .	pres_fut	665
We support Anbar much more than before .	We will support Anbar much more than before .	pres_fut	667
Then we go and Google Blue Ridge Capital .	Then we will go and Google Blue Ridge Capital .	pres_fut	669
I preserve my impartiality with the greatest of care .	I will preserve my impartiality with the greatest of care .	pres_fut	670
" I cry on my own , " he said .	" I will cry on my own , " he said .	pres_fut	672
I stand up for our schools and hospitals .	I will stand up for our schools and hospitals .	pres_fut	673
I think we win .	I think we will win .	pres_fut	675
Whether you buy his portrait of Thomas Jefferson is another story .	Whether you will buy his portrait of Thomas Jefferson is another story .	pres_fut	677
It is something they treasure for the rest of their lives .	It is something they will treasure for the rest of their lives .	pres_fut	678
And we give them everything they need to succeed .	And we will give them everything they need to succeed .	pres_fut	679
But we give it the best shot we have .	But we will give it the best shot we have .	pres_fut	682
We do our best .	We will do our best .	pres_fut	686
We continue these protests peacefully every day until we win .	We will continue these protests peacefully every day until we win .	pres_fut	687
" I look into what had happened , " he said .	" I will look into what had happened , " he said .	pres_fut	689
I am sure we break it in 2008 .	I am sure we will break it in 2008 .	pres_fut	692
We track them very carefully .	We will track them very carefully .	pres_fut	693
Tonight they sleep on foreign sand .	Tonight they will sleep on foreign sand .	pres_fut	695
Maybe they take them off me then .	Maybe they will take them off me then .	pres_fut	697
We go forward in a very strong way .	We will go forward in a very strong way .	pres_fut	698
Give them to me , I take care of them .	Give them to me , I will take care of them .	pres_fut	699
They leave the mountains .	They will leave the mountains .	pres_fut	701
And they suffer greatly .	And they will suffer greatly .	pres_fut	702
We find out what the policy is .	We will find out what the policy is .	pres_fut	703
If not we stop right now .	If not we will stop right now .	pres_fut	704
But they listen .	But they will listen .	pres_fut	705
We drink a glass of champagne or more .	We will drink a glass of champagne or more .	pres_fut	707
I miss the unique artist with such a big heart .	I will miss the unique artist with such a big heart .	pres_fut	708
We help them to progress .	We will help them to progress .	pres_fut	709
They walk the streets between 2200 and 0400 BST at the weekends .	They will walk the streets between 2200 and 0400 BST at the weekends .	pres_fut	712
We support a referendum .	We will support a referendum .	pres_fut	713
They sell for about $ 15 a bottle .	They will sell for about $ 15 a bottle .	pres_fut	715
They need refrigerators and portable sinks .	They will need refrigerators and portable sinks .	pres_fut	716
I win next time round .	I will win next time round .	pres_fut	717
I promise we try to go .	I promise we will try to go .	pres_fut	718
So I put it down to a bad day at the office .	So I will put it down to a bad day at the office .	pres_fut	720
They burn in hellfire on this earth and in the hereafter .	They will burn in hellfire on this earth and in the hereafter .	pres_fut	721
They face a new trial next month .	They will face a new trial next month .	pres_fut	724
We continue to work judiciously to review this matter .	We will continue to work judiciously to review this matter .	pres_fut	725
I am quite convinced we win it .	I am quite convinced we will win it .	pres_fut	726
I guess we see how it goes .	I guess we will see how it goes .	pres_fut	728
I continue to say what I believe .	I will continue to say what I believe .	pres_fut	730
we run trains if the Government funds them .	we will run trains if the Government funds them .	pres_fut	731
I come and be with you forever .	I will come and be with you forever .	pres_fut	732
If they have interest we see where we go .	If they have interest we will see where we go .	pres_fut	733
But , God willing , we get rid of them .	But , God willing , we will get rid of them .	pres_fut	736
I miss his guidance , encouragement and friendship .	I will miss his guidance , encouragement and friendship .	pres_fut	737
But we see the next couple of days .	But we will see the next couple of days .	pres_fut	738
We are saying we negotiate with them .	We are saying we will negotiate with them .	pres_fut	739
" " I give you a real burial .	" " I will give you a real burial .	pres_fut	740
Maybe they listen now .	Maybe they will listen now .	pres_fut	741
Next time , I try to do better .	Next time , I will try to do better .	pres_fut	744
But , for now , we battle .	But , for now , we will battle .	pres_fut	745
Somehow , they spawn accessories .	Somehow , they will spawn accessories .	pres_fut	746
Just to say yes I marry you .	Just to say yes I will marry you .	pres_fut	747
For this you need a race licence .	For this you will need a race licence .	pres_fut	748
So we see what happens there .	So we will see what happens there .	pres_fut	749
You get in the way .	You will get in the way .	pres_fut	750
We are prepared for whatever they throw at us .	We are prepared for whatever they will throw at us .	pres_fut	751
With any luck , we get there .	With any luck , we will get there .	pres_fut	753
We respond to any attack .	We will respond to any attack .	pres_fut	754
I do not think we see change .	I do not think we will see change .	pres_fut	755
They get you .	They will get you .	pres_fut	757
Hopefully we move beyond this fairly soon .	Hopefully we will move beyond this fairly soon .	pres_fut	759
We resist it but the parliamentary arithmetic will decide it .	We will resist it but the parliamentary arithmetic will decide it .	pres_fut	760
THEN we open that discussion .	THEN we will open that discussion .	pres_fut	761
" And I tell you this , " Neuzil says .	" And I will tell you this , " Neuzil says .	pres_fut	762
You entertain more .	You will entertain more .	pres_fut	763
There has been plenty of speculation , I say that .	There has been plenty of speculation , I will say that .	pres_fut	765
I get to the Kermit Lynch wines soon , I promise .	I will get to the Kermit Lynch wines soon , I promise .	pres_fut	767
They do not know what we do .	They do not know what we will do .	pres_fut	769
But if not , we continue .	But if not , we will continue .	pres_fut	770
I explain what he means with an oversimplified example .	I will explain what he means with an oversimplified example .	pres_fut	771
I am guilty , and I take my punishment .	I am guilty , and I will take my punishment .	pres_fut	773
We bounce back .	We will bounce back .	pres_fut	774
We continue to do so .	We will continue to do so .	pres_fut	776
In addition , we offer five SNPs in 2008 .	In addition , we will offer five SNPs in 2008 .	pres_fut	779
We help counter the false populism promoted by hostile nations .	We will help counter the false populism promoted by hostile nations .	pres_fut	781
And that is what I talk about .	And that is what I will talk about .	pres_fut	782
This time , they say the risks have increased .	This time , they will say the risks have increased .	pres_fut	785
I behave by whatever the rules are .	I will behave by whatever the rules are .	pres_fut	786
If you stand off you pay the price .	If you stand off you will pay the price .	pres_fut	787
We return the rest later .	We will return the rest later .	pres_fut	789
I seize that opportunity by reintroducing ourselves to the world .	I will seize that opportunity by reintroducing ourselves to the world .	pres_fut	791
I instil our own style of discipline .	I will instil our own style of discipline .	pres_fut	792
They try to hold on to the shore .	They will try to hold on to the shore .	pres_fut	793
And we take revenge .	And we will take revenge .	pres_fut	794
We know very soon which countries are supporting this .	We will know very soon which countries are supporting this .	pres_fut	796
We hope they cooperate with us .	We hope they will cooperate with us .	pres_fut	799
He is looking good in training and we see .	He is looking good in training and we will see .	pres_fut	801
We do everything to expose this odious crime .	We will do everything to expose this odious crime .	pres_fut	803
You need all the guidance you can get .	You will need all the guidance you can get .	pres_fut	804
If not , we go from there .	If not , we will go from there .	pres_fut	806
They know soon enough whether they got their money 's worth .	They will know soon enough whether they got their money 's worth .	pres_fut	807
We win .	We will win .	pres_fut	808
" " But we get it done .	" " But we will get it done .	pres_fut	810
" " We miss him for many years .	" " We will miss him for many years .	pres_fut	811
We strengthen the hand of protectionist lobbies beyond our borders .	We will strengthen the hand of protectionist lobbies beyond our borders .	pres_fut	812
Now they see whether users share their vision .	Now they will see whether users share their vision .	pres_fut	813
They play against Italian side Inter Milan .	They will play against Italian side Inter Milan .	pres_fut	814
They fail .	They will fail .	pres_fut	819
They lose their homes .	They will lose their homes .	pres_fut	824
What a difference they make to our collections .	What a difference they will make to our collections .	pres_fut	827
" " So we see what happens .	" " So we will see what happens .	pres_fut	829
They learn about liberation movements , but only socialist ones .	They will learn about liberation movements , but only socialist ones .	pres_fut	830
I doubt they recur .	I doubt they will recur .	pres_fut	831
You see the Iranians move in and pick sides among the Shias .	You will see the Iranians move in and pick sides among the Shias .	pres_fut	832
They answer your questions on News 24 on Thursday November 1st .	They will answer your questions on News 24 on Thursday November 1st .	pres_fut	833
We hire the best person we can .	We will hire the best person we can .	pres_fut	834
It is quite possible they get out of the group .	It is quite possible they will get out of the group .	pres_fut	835
We Fear They Break Away .	We Fear They Will Break Away .	pres_fut	836
I miss Rolls- Royce and the great friends I have made here .	I will miss Rolls- Royce and the great friends I have made here .	pres_fut	837
We make sure the target is implemented and achieved .	We will make sure the target is implemented and achieved .	pres_fut	838
When Opec meets , we discuss this issue .	When Opec meets , we will discuss this issue .	pres_fut	840
I do not know what we do without it .	I do not know what we will do without it .	pres_fut	843
" We hope they come to their senses , " he said .	" We hope they will come to their senses , " he said .	pres_fut	846
I guess we find out .	I guess we will find out .	pres_fut	847
We know at the end of ten years .	We will know at the end of ten years .	pres_fut	848
They play on any MP3 player .	They will play on any MP3 player .	pres_fut	849
So I refrain from endorsing that spot .	So I will refrain from endorsing that spot .	pres_fut	850
At which point , we break up .	At which point , we will break up .	pres_fut	851
It is not nearly as simple as build it and they come .	It is not nearly as simple as build it and they will come .	pres_fut	853
We fight - Britain will win .	We will fight - Britain will win .	pres_fut	854
They think we are not serious .	They will think we are not serious .	pres_fut	855
That is how we look at it from here on .	That is how we will look at it from here on .	pres_fut	856
" I think we win 21-18 , " he said .	" I think we will win 21-18 , " he said .	pres_fut	858
As committed soldiers , we see this mission through .	As committed soldiers , we will see this mission through .	pres_fut	859
We make it work either way .	We will make it work either way .	pres_fut	860
Maybe we find " Cheers ' soon .	Maybe we will find " Cheers ' soon .	pres_fut	863
But we move on .	But we will move on .	pres_fut	865
We follow it until we kill the last terrorist in Iraq .	We will follow it until we kill the last terrorist in Iraq .	pres_fut	866
We do it next time .	We will do it next time .	pres_fut	868
" I think we get there , " he said .	" I think we will get there , " he said .	pres_fut	871
We make sure we have the same vigilance this week .	We will make sure we have the same vigilance this week .	pres_fut	874
We continue to fly for Apple from Rockford , IL .	We will continue to fly for Apple from Rockford , IL .	pres_fut	875
We remove all the hindrances and obstacles that may lie ahead .	We will remove all the hindrances and obstacles that may lie ahead .	pres_fut	876
But they continue to monitor in-game attire .	But they will continue to monitor in-game attire .	pres_fut	877
They are concerned for Lute personally , not how they respond .	They are concerned for Lute personally , not how they will respond .	pres_fut	878
We have committed ourselves to dismantling illegal outposts and we remove them .	We have committed ourselves to dismantling illegal outposts and we will remove them .	pres_fut	879
We see where it goes from there .	We will see where it goes from there .	pres_fut	882
If they ask for one we provide it .	If they ask for one we will provide it .	pres_fut	885
If you meet me you learn about the culture .	If you meet me you will learn about the culture .	pres_fut	886
We become cities and lose our culture .	We will become cities and lose our culture .	pres_fut	887
We continue to meet the public .	We will continue to meet the public .	pres_fut	888
They hope to secure a move for Berbatov in January .	They will hope to secure a move for Berbatov in January .	pres_fut	889
Maulvi Sahib : OK , I come .	Maulvi Sahib : OK , I will come .	pres_fut	890
They enter pleas at Birmingham Crown Court on November 26 .	They will enter pleas at Birmingham Crown Court on November 26 .	pres_fut	892
As they are hustlers , they take your money .	As they are hustlers , they will take your money .	pres_fut	893
Maybe we stop being the has-been players retirement center .	Maybe we will stop being the has-been players retirement center .	pres_fut	895
And we work according -- together accordingly .	And we will work according -- together accordingly .	pres_fut	896
" We fight until our last , " Raja said .	" We will fight until our last , " Raja said .	pres_fut	897
We fight for Russia 's right to this plot .	We will fight for Russia 's right to this plot .	pres_fut	898
This will be the fourth year that I wear it .	This will be the fourth year that I will wear it .	pres_fut	900
We strengthen the democracy and unity of our country .	We will strengthen the democracy and unity of our country .	pres_fut	902
Then we sell more than 10 million a year .	Then we will sell more than 10 million a year .	pres_fut	903
We hope they do that .	We hope they will do that .	pres_fut	904
They know who he is now .	They will know who he is now .	pres_fut	905
I would like to play again soon and expect that I do .	I would like to play again soon and expect that I will do .	pres_fut	906
I beat Joe Calzaghe easily .	I will beat Joe Calzaghe easily .	pres_fut	907
I review all entries in a couple of weeks .	I will review all entries in a couple of weeks .	pres_fut	909
We agree there may be odd people in hideouts .	We will agree there may be odd people in hideouts .	pres_fut	910
I encourage , but not force anyone to do anything .	I will encourage , but not force anyone to do anything .	pres_fut	912
" But I am convinced they return home , " he said .	" But I am convinced they will return home , " he said .	pres_fut	914
They host Avram Grant 's Chelsea in the first leg .	They will host Avram Grant 's Chelsea in the first leg .	pres_fut	915
And I remind you that I predicted it .	And I will remind you that I predicted it .	pres_fut	917
It is in that spirit that I meet with President Assad .	It is in that spirit that I will meet with President Assad .	pres_fut	918
You start hearing all these sounds coming in .	You will start hearing all these sounds coming in .	pres_fut	919
" I support the strongest European bid , " he said .	" I will support the strongest European bid , " he said .	pres_fut	920
You lose your licence .	You will lose your licence .	pres_fut	921
Also , we improve stroke care .	Also , we will improve stroke care .	pres_fut	922
But we can and we recover from this .	But we can and we will recover from this .	pres_fut	924
We make our own history on Saturday .	We will make our own history on Saturday .	pres_fut	926
" We continue to take those precautions , " he said .	" We will continue to take those precautions , " he said .	pres_fut	927
No , I try to win .	No , I will try to win .	pres_fut	928
Now we see how he matches up against the top 3-year-olds .	Now we will see how he matches up against the top 3-year-olds .	pres_fut	930
Buy yourself a gift that you enjoy .	Buy yourself a gift that you will enjoy .	pres_fut	931
They break up the gangs .	They will break up the gangs .	pres_fut	933
If I want something , I barter for it .	If I want something , I will barter for it .	pres_fut	934
I fight you if I have to .	I will fight you if I have to .	pres_fut	935
We see whether those hopes and dreams get realized .	We will see whether those hopes and dreams get realized .	pres_fut	940
If you attach a pedometer to your belt , you move more .	If you attach a pedometer to your belt , you will move more .	pres_fut	941
The NHS has values which we defend .	The NHS has values which we will defend .	pres_fut	942
You need Ordnance Survey map 35 , Kingussie & Monadhliath Mountains .	You will need Ordnance Survey map 35 , Kingussie & Monadhliath Mountains .	pres_fut	944
We use the demographic shift in Scotland to deliver this .	We will use the demographic shift in Scotland to deliver this .	pres_fut	945
" " That is what we try to do .	" " That is what we will try to do .	pres_fut	946
It is a process and we go through the process .	It is a process and we will go through the process .	pres_fut	947
Anything I Can Do For My Sport I Do .	Anything I Can Do For My Sport I Will Do .	pres_fut	949
They resume on Monday .	They will resume on Monday .	pres_fut	950
I keep my focus on the concerns of the country .	I will keep my focus on the concerns of the country .	pres_fut	951
They become , over time , users .	They will become , over time , users .	pres_fut	952
I continue to make mistakes .	I will continue to make mistakes .	pres_fut	953
" " Demand and you receive .	" " Demand and you will receive .	pres_fut	954
They receive standard treatment followed by radiation and concurrent chemotherapy .	They will receive standard treatment followed by radiation and concurrent chemotherapy .	pres_fut	957
We see how he is .	We will see how he is .	pres_fut	958
Maybe now we see why .	Maybe now we will see why .	pres_fut	959
You need a set-top box for every TV you own .	You will need a set-top box for every TV you own .	pres_fut	960
They thrive in the moist , rich conditions that trenching creates .	They will thrive in the moist , rich conditions that trenching creates .	pres_fut	961
They see it is senseless in many ways .	They will see it is senseless in many ways .	pres_fut	963
" We continue , " he said .	" We will continue , " he said .	pres_fut	964
They face East Carolina in today 's tournament championship game .	They will face East Carolina in today 's tournament championship game .	pres_fut	965
They take orders from no other country .	They will take orders from no other country .	pres_fut	966
" I remember that , " Zambrano said of the fan reaction .	" I will remember that , " Zambrano said of the fan reaction .	pres_fut	968
We close Guantanamo .	We will close Guantanamo .	pres_fut	970
We deny millions of African farmers a lifeline out of poverty .	We will deny millions of African farmers a lifeline out of poverty .	pres_fut	971
One of these days we come for you .	One of these days we will come for you .	pres_fut	975
We go into this game with confidence .	We will go into this game with confidence .	pres_fut	976
They face Furman in today 's tournament consolation game .	They will face Furman in today 's tournament consolation game .	pres_fut	979
They start seeing tiny colored icons alongside links their friends have rated .	They will start seeing tiny colored icons alongside links their friends have rated .	pres_fut	980
If it does not , then we take another look at it .	If it does not , then we will take another look at it .	pres_fut	985
If he dies , you lose everything .	If he dies , you will lose everything .	pres_fut	986
I miss her as a friend and colleague .	I will miss her as a friend and colleague .	pres_fut	988
But we go through every detail of that trial .	But we will go through every detail of that trial .	pres_fut	990
You need Ordnance Survey map 51 , Loch Tay & Glen Dochart .	You will need Ordnance Survey map 51 , Loch Tay & Glen Dochart .	pres_fut	993
We see a growing anti-Musharraf , anti-Government sentiment developing in the country .	We will see a growing anti-Musharraf , anti-Government sentiment developing in the country .	pres_fut	994
We become first-class .	We will become first-class .	pres_fut	995
I miss him desperately .	I will miss him desperately .	pres_fut	996
We co-operate with our neighbours in defeating this threat .	We will co-operate with our neighbours in defeating this threat .	pres_fut	999
We take it to the end .	We will take it to the end .	pres_fut	1000
They deliver a great fight .	They will deliver a great fight .	pres_fut	1001
" " We assist them in any way we can .	" " We will assist them in any way we can .	pres_fut	1004
But next time around , we do better .	But next time around , we will do better .	pres_fut	1006
They decide on compensatory damages later .	They will decide on compensatory damages later .	pres_fut	1010
